"","STNAME","CTYNAME","YEAR","state_po","totalvotes","county_fips","DEMOCRAT","OTHER","REPUBLICAN","winner","percent_rep","age","TOT_POP","TOT_MALE","TOT_FEMALE","WA_MALE","WA_FEMALE","BA_MALE","BA_FEMALE","IA_MALE","IA_FEMALE","AA_MALE","AA_FEMALE","TOM_MALE","TOM_FEMALE","NH_MALE","NH_FEMALE","H_MALE","H_FEMALE","MINORITY_MALE","MINORITY_FEMALE"
"1","ARIZONA","MARICOPA",2016,"AZ",1567834,4013,702907,117566,747361,"R",0.515326132825105,"ages 15-34",1196414,610812,585602,491450,469607,44457,41183,21012,21572,30523,29931,21084,21256,382277,366389,228535,219213,119362,115995
"2","ARIZONA","MARICOPA",2016,"AZ",1567834,4013,702907,117566,747361,"R",0.515326132825105,"ages 35-64",1579318,775391,803927,663003,681195,45184,45596,17587,19769,35301,41617,12200,13692,571751,595404,203640,208523,112388,122732
"3","ARIZONA","MARICOPA",2016,"AZ",1567834,4013,702907,117566,747361,"R",0.515326132825105,"ages 65+",615206,277269,337937,257081,310497,8490,10999,2316,3243,7207,10471,1868,2382,247740,300802,29529,37135,20188,27440
"4","ARIZONA","MARICOPA",2016,"AZ",1567834,4013,702907,117566,747361,"R",0.515326132825105,"total",4258019,2105955,2152064,1759283,1794413,130114,128168,57863,60997,91221,100027,61351,62695,1450238,1500602,655717,651462,346672,357651
"5","ARIZONA","MARICOPA",2020,"AZ",2068144,4013,1040774,31705,995665,"D",0.488924539355218,"ages 15-34",1280884,653727,627157,519470,496825,50857,47129,22447,22970,32328,32016,26230,26046,401820,383280,251907,243877,134257,130332
"6","ARIZONA","MARICOPA",2020,"AZ",2068144,4013,1040774,31705,995665,"D",0.488924539355218,"ages 35-64",1694308,834687,859621,702174,715226,52675,53897,20007,22599,42461,48569,14798,16840,600824,621224,233863,238397,132513,144395
"7","ARIZONA","MARICOPA",2020,"AZ",2068144,4013,1040774,31705,995665,"D",0.488924539355218,"ages 65+",729812,328936,400876,301521,363862,11511,14563,3147,4328,9734,14467,2586,3172,290231,352111,38705,48765,27415,37014
"8","ARIZONA","MARICOPA",2020,"AZ",2068144,4013,1040774,31705,995665,"D",0.488924539355218,"total",4579081,2263436,2315645,1865814,1903568,150288,149713,63887,67338,104110,114300,72418,74098,1540921,1594982,722515,720663,397622,412077
"9","CALIFORNIA","BUTTE",2016,"CA",95564,6007,41567,8853,45144,"R",0.520625987475637,"ages 15-34",70005,35971,34034,29762,28022,892,663,890,925,2457,2272,1833,2038,28818,27132,7153,6902,6209,6012
"10","CALIFORNIA","BUTTE",2016,"CA",95564,6007,41567,8853,45144,"R",0.520625987475637,"ages 35-64",78254,38497,39757,34331,35416,766,512,890,987,1404,1592,1018,1156,33087,34725,5410,5032,4166,4341
"11","CALIFORNIA","BUTTE",2016,"CA",95564,6007,41567,8853,45144,"R",0.520625987475637,"ages 65+",40287,18034,22253,16908,20903,183,192,285,305,366,487,257,332,16883,21000,1151,1253,1126,1350
"12","CALIFORNIA","BUTTE",2016,"CA",95564,6007,41567,8853,45144,"R",0.520625987475637,"total",226222,111795,114427,96265,98970,2253,1747,2768,2895,5424,5426,4756,5083,93405,96657,18390,17770,15530,15457
"13","CALIFORNIA","BUTTE",2020,"CA",102066,6007,50426,2910,48730,"D",0.491447819597402,"ages 15-34",66129,33700,32429,27566,26346,866,683,909,928,2352,2233,1894,2132,26168,25113,7532,7316,6134,6083
"14","CALIFORNIA","BUTTE",2020,"CA",102066,6007,50426,2910,48730,"D",0.491447819597402,"ages 35-64",71932,35616,36316,31257,31851,800,546,899,989,1553,1715,1020,1118,29770,30898,5846,5418,4359,4465
"15","CALIFORNIA","BUTTE",2020,"CA",102066,6007,50426,2910,48730,"D",0.491447819597402,"ages 65+",39082,17658,21424,16402,19911,200,213,307,323,424,583,282,353,16305,19994,1353,1430,1256,1513
"16","CALIFORNIA","BUTTE",2020,"CA",102066,6007,50426,2910,48730,"D",0.491447819597402,"total",212744,105259,107485,89410,91680,2319,1827,2806,2877,5508,5569,4903,5224,85935,88775,19324,18710,15849,15805
"17","CALIFORNIA","INYO",2016,"CA",8086,6027,3155,683,4248,"R",0.57382142374713,"ages 15-34",3787,1965,1822,1457,1351,51,25,331,324,30,33,90,86,1381,1278,584,544,508,471
"18","CALIFORNIA","INYO",2016,"CA",8086,6027,3155,683,4248,"R",0.57382142374713,"ages 35-64",7052,3530,3522,2989,2905,42,16,375,424,53,86,64,87,2890,2901,640,621,541,617
"19","CALIFORNIA","INYO",2016,"CA",8086,6027,3155,683,4248,"R",0.57382142374713,"ages 65+",4000,1908,2092,1730,1855,5,2,126,182,24,21,22,31,1781,1958,127,134,178,237
"20","CALIFORNIA","INYO",2016,"CA",8086,6027,3155,683,4248,"R",0.57382142374713,"total",17897,8988,8909,7267,7153,116,58,1161,1219,130,158,297,312,7006,7001,1982,1908,1721,1756
"21","CALIFORNIA","INYO",2020,"CA",9484,6027,4634,230,4620,"D",0.499243570347958,"ages 15-34",3662,1872,1790,1392,1321,52,28,304,307,41,30,78,100,1277,1207,595,583,480,469
"22","CALIFORNIA","INYO",2020,"CA",9484,6027,4634,230,4620,"D",0.499243570347958,"ages 35-64",6870,3483,3387,2860,2722,51,30,425,460,57,82,84,89,2706,2707,777,680,623,665
"23","CALIFORNIA","INYO",2020,"CA",9484,6027,4634,230,4620,"D",0.499243570347958,"ages 65+",4385,2116,2269,1898,1981,5,2,152,213,30,26,28,46,1938,2079,178,190,218,288
"24","CALIFORNIA","INYO",2020,"CA",9484,6027,4634,230,4620,"D",0.499243570347958,"total",18046,9033,9013,7214,7116,132,84,1204,1289,147,151,319,362,6854,6919,2179,2094,1819,1897
"25","COLORADO","ALAMOSA",2016,"CO",6939,8003,3189,704,3046,"D",0.488532477947073,"ages 15-34",5448,2753,2695,2378,2346,80,68,135,148,47,51,104,69,1399,1360,1354,1335,375,349
"26","COLORADO","ALAMOSA",2016,"CO",6939,8003,3189,704,3046,"D",0.488532477947073,"ages 35-64",5174,2571,2603,2273,2333,54,23,149,142,36,45,55,55,1467,1447,1104,1156,298,270
"27","COLORADO","ALAMOSA",2016,"CO",6939,8003,3189,704,3046,"D",0.488532477947073,"ages 65+",2133,1001,1132,934,1069,5,3,42,27,8,9,11,23,680,736,321,396,67,63
"28","COLORADO","ALAMOSA",2016,"CO",6939,8003,3189,704,3046,"D",0.488532477947073,"total",16047,8046,8001,7037,7094,166,118,448,417,119,128,259,219,4310,4267,3736,3734,1009,907
"29","COLORADO","ALAMOSA",2020,"CO",7808,8003,3759,236,3813,"R",0.503565768621236,"ages 15-34",5395,2699,2696,2324,2331,81,77,129,153,58,49,97,72,1337,1351,1362,1345,375,365
"30","COLORADO","ALAMOSA",2020,"CO",7808,8003,3759,236,3813,"R",0.503565768621236,"ages 35-64",5101,2479,2622,2178,2337,63,23,143,146,32,48,58,61,1366,1435,1113,1187,301,285
"31","COLORADO","ALAMOSA",2020,"CO",7808,8003,3759,236,3813,"R",0.503565768621236,"ages 65+",2391,1129,1262,1034,1176,8,7,53,35,18,10,15,33,741,788,388,474,95,86
"32","COLORADO","ALAMOSA",2020,"CO",7808,8003,3759,236,3813,"R",0.503565768621236,"total",16180,8001,8179,6916,7194,197,136,464,442,136,131,264,249,4187,4265,3814,3914,1085,985
"33","COLORADO","CHAFFEE",2016,"CO",11250,8015,4888,971,5391,"R",0.524467360638194,"ages 15-34",4097,2448,1649,2165,1537,172,10,42,36,22,20,45,44,1901,1468,547,181,283,112
"34","COLORADO","CHAFFEE",2016,"CO",11250,8015,4888,971,5391,"R",0.524467360638194,"ages 35-64",7999,4235,3764,3947,3604,121,7,81,58,32,39,45,52,3815,3505,420,259,288,160
"35","COLORADO","CHAFFEE",2016,"CO",11250,8015,4888,971,5391,"R",0.524467360638194,"ages 65+",4612,2268,2344,2226,2295,3,2,11,18,7,14,20,14,2170,2234,98,110,42,49
"36","COLORADO","CHAFFEE",2016,"CO",11250,8015,4888,971,5391,"R",0.524467360638194,"total",19140,10222,8918,9478,8505,321,30,164,135,73,87,173,154,8983,8210,1239,708,744,413
"37","COLORADO","CHAFFEE",2020,"CO",13718,8015,7160,336,6222,"D",0.464952921835301,"ages 15-34",4413,2627,1786,2289,1656,193,16,46,38,30,24,67,50,2088,1583,539,203,338,130
"38","COLORADO","CHAFFEE",2020,"CO",13718,8015,7160,336,6222,"D",0.464952921835301,"ages 35-64",8288,4328,3960,4029,3790,122,12,90,56,34,37,44,61,3902,3686,426,274,299,170
"39","COLORADO","CHAFFEE",2020,"CO",13718,8015,7160,336,6222,"D",0.464952921835301,"ages 65+",5453,2651,2802,2592,2732,6,4,16,25,13,22,21,18,2529,2684,122,118,59,70
"40","COLORADO","CHAFFEE",2020,"CO",13718,8015,7160,336,6222,"D",0.464952921835301,"total",20661,10925,9736,10107,9248,345,44,175,151,91,101,192,185,9662,8978,1263,758,818,488
"41","COLORADO","GARFIELD",2016,"CO",26470,8045,11271,2067,13132,"R",0.538130557718313,"ages 15-34",15496,8056,7440,7489,6915,151,109,154,149,64,102,183,150,5306,4942,2750,2498,567,525
"42","COLORADO","GARFIELD",2016,"CO",26470,8045,11271,2067,13132,"R",0.538130557718313,"ages 35-64",23819,12140,11679,11540,11121,150,78,184,171,88,129,161,161,9368,9152,2772,2527,600,558
"43","COLORADO","GARFIELD",2016,"CO",26470,8045,11271,2067,13132,"R",0.538130557718313,"ages 65+",6925,3356,3569,3259,3467,19,17,33,19,12,31,31,35,3133,3325,223,244,97,102
"44","COLORADO","GARFIELD",2016,"CO",26470,8045,11271,2067,13132,"R",0.538130557718313,"total",58839,29967,28872,28193,27208,418,287,511,475,214,326,589,531,21472,20969,8495,7903,1774,1664
"45","COLORADO","GARFIELD",2020,"CO",30904,8045,15427,760,14717,"D",0.488223195329087,"ages 15-34",15531,8154,7377,7487,6851,169,93,165,145,85,102,236,168,5169,4752,2985,2625,667,526
"46","COLORADO","GARFIELD",2020,"CO",30904,8045,15427,760,14717,"D",0.488223195329087,"ages 35-64",23678,12125,11553,11475,10944,166,114,193,187,95,118,172,166,9024,8810,3101,2743,650,609
"47","COLORADO","GARFIELD",2020,"CO",30904,8045,15427,760,14717,"D",0.488223195329087,"ages 65+",8616,4174,4442,4038,4304,23,20,45,35,14,39,51,41,3843,4106,331,336,136,138
"48","COLORADO","GARFIELD",2020,"CO",30904,8045,15427,760,14717,"D",0.488223195329087,"total",60366,30857,29509,28900,27747,476,320,542,505,250,330,637,549,21579,21052,9278,8457,1957,1762
"49","COLORADO","PUEBLO",2016,"CO",78646,8101,35875,6506,36265,"R",0.502703077349598,"ages 15-34",42684,21778,20906,19323,18554,793,601,701,752,239,261,669,692,11055,10474,10723,10432,2455,2352
"50","COLORADO","PUEBLO",2016,"CO",78646,8101,35875,6506,36265,"R",0.502703077349598,"ages 35-64",61820,30141,31679,27517,29159,792,570,947,897,294,409,550,598,18528,19349,11613,12330,2624,2520
"51","COLORADO","PUEBLO",2016,"CO",78646,8101,35875,6506,36265,"R",0.502703077349598,"ages 65+",29236,13246,15990,12561,15261,216,186,232,256,80,111,143,161,9442,11407,3804,4583,685,729
"52","COLORADO","PUEBLO",2016,"CO",78646,8101,35875,6506,36265,"R",0.502703077349598,"total",164883,81192,83691,73114,75962,2285,1827,2684,2628,788,949,2185,2181,46137,47919,35055,35772,8078,7729
"53","COLORADO","PUEBLO",2020,"CO",88301,8101,43772,2277,42252,"D",0.49116525620757,"ages 15-34",43616,22419,21197,19608,18539,884,668,762,778,247,303,866,864,11206,10547,11213,10650,2811,2658
"54","COLORADO","PUEBLO",2020,"CO",88301,8101,43772,2277,42252,"D",0.49116525620757,"ages 35-64",62273,30555,31718,27755,28964,836,621,938,942,348,457,632,672,18436,18837,12119,12881,2800,2754
"55","COLORADO","PUEBLO",2020,"CO",88301,8101,43772,2277,42252,"D",0.49116525620757,"ages 65+",32929,14840,18089,14021,17097,250,234,268,337,101,157,182,247,10448,12734,4392,5355,819,992
"56","COLORADO","PUEBLO",2020,"CO",88301,8101,43772,2277,42252,"D",0.49116525620757,"total",169823,83681,86142,74608,77404,2531,2039,2834,2849,880,1105,2672,2582,47269,48921,36412,37221,9073,8738
"57","DELAWARE","KENT",2016,"DE",74598,10001,33351,4256,36991,"R",0.525873589036422,"ages 15-34",48468,24309,24159,15392,14613,7143,7673,176,166,584,523,970,1144,22237,22214,2072,1945,8917,9546
"58","DELAWARE","KENT",2016,"DE",74598,10001,33351,4256,36991,"R",0.525873589036422,"ages 35-64",64144,30191,33953,21579,23315,7110,8651,242,285,695,1016,533,641,28397,32153,1794,1800,8612,10638
"59","DELAWARE","KENT",2016,"DE",74598,10001,33351,4256,36991,"R",0.525873589036422,"ages 65+",28486,12661,15825,9933,12036,2346,3121,87,122,187,399,105,144,12371,15417,290,408,2728,3789
"60","DELAWARE","KENT",2016,"DE",74598,10001,33351,4256,36991,"R",0.525873589036422,"total",174776,84216,90560,57319,59988,21399,24142,593,701,1766,2263,3038,3358,78176,84546,6040,6014,26897,30572
"61","DELAWARE","KENT",2020,"DE",87025,10001,44552,1464,41009,"D",0.479295473404939,"ages 15-34",49742,24881,24861,15150,14498,7698,8335,146,162,617,535,1234,1296,22547,22580,2334,2281,9731,10363
"62","DELAWARE","KENT",2020,"DE",87025,10001,44552,1464,41009,"D",0.479295473404939,"ages 35-64",66205,31069,35136,21390,23361,7965,9616,251,293,779,1056,647,763,28896,32928,2173,2208,9679,11775
"63","DELAWARE","KENT",2020,"DE",87025,10001,44552,1464,41009,"D",0.479295473404939,"ages 65+",32951,14582,18369,11060,13462,3024,4073,114,140,224,501,152,182,14194,17837,388,532,3522,4907
"64","DELAWARE","KENT",2020,"DE",87025,10001,44552,1464,41009,"D",0.479295473404939,"total",183643,88384,95259,57987,61358,24096,26974,629,706,1965,2399,3600,3710,81375,88153,7009,7106,30397,33901
"65","FLORIDA","DUVAL",2016,"FL",432695,12031,205704,15319,211672,"R",0.50714942881239,"ages 15-34",270897,136087,134810,81847,77245,42233,45455,674,601,6745,6778,4385,4528,120765,120702,15322,14108,54240,57565
"66","FLORIDA","DUVAL",2016,"FL",432695,12031,205704,15319,211672,"R",0.50714942881239,"ages 35-64",355032,170364,184668,113313,114184,45209,56405,884,878,8259,10036,2457,2968,155615,169997,14749,14671,57051,70484
"67","FLORIDA","DUVAL",2016,"FL",432695,12031,205704,15319,211672,"R",0.50714942881239,"ages 65+",123577,52881,70696,39853,51110,10241,15830,200,264,2221,2938,337,511,50486,67442,2395,3254,13028,19586
"68","FLORIDA","DUVAL",2016,"FL",432695,12031,205704,15319,211672,"R",0.50714942881239,"total",927038,449953,477085,281294,286701,131849,150357,2075,2057,21184,23922,12980,13499,406483,434229,43470,42856,168659,190384
"69","FLORIDA","DUVAL",2020,"FL",492820,12031,252556,6502,233762,"D",0.480677252332836,"ages 15-34",275983,138821,137162,81402,76998,44360,47110,667,602,7028,7070,5175,5199,121040,120538,17781,16624,57419,60164
"70","FLORIDA","DUVAL",2020,"FL",492820,12031,252556,6502,233762,"D",0.480677252332836,"ages 35-64",363029,174070,188959,113670,114377,47345,59282,866,895,9085,10854,2812,3348,155038,170336,19032,18623,60400,74582
"71","FLORIDA","DUVAL",2020,"FL",492820,12031,252556,6502,233762,"D",0.480677252332836,"ages 65+",143432,61570,81862,45423,57623,12571,19472,281,338,2809,3742,446,633,58326,77377,3244,4485,16147,24239
"72","FLORIDA","DUVAL",2020,"FL",492820,12031,252556,6502,233762,"D",0.480677252332836,"total",966728,468251,498477,287889,294760,139602,159997,2222,2202,23054,25852,14859,15109,414928,445504,53323,52973,180362,203717
"73","FLORIDA","PINELLAS",2016,"FL",492403,12103,233701,19501,239201,"R",0.505815158320329,"ages 15-34",209255,104358,104897,80606,79940,15736,16348,543,464,4203,4549,3114,3420,90303,91522,14055,13375,23752,24957
"74","FLORIDA","PINELLAS",2016,"FL",492403,12103,233701,19501,239201,"R",0.505815158320329,"ages 35-64",391196,188133,203063,160749,170236,17673,20989,839,847,6455,8265,2219,2496,172120,186094,16013,16969,27384,32827
"75","FLORIDA","PINELLAS",2016,"FL",492403,12103,233701,19501,239201,"R",0.505815158320329,"ages 65+",228731,101708,127023,94181,116928,4776,6664,246,233,1877,2480,576,678,97854,121879,3854,5144,7527,10095
"76","FLORIDA","PINELLAS",2016,"FL",492403,12103,233701,19501,239201,"R",0.505815158320329,"total",960527,461124,499403,383009,412549,50273,55761,1916,1818,15208,17972,10168,10712,416531,453450,44593,45953,78115,86854
"77","FLORIDA","PINELLAS",2020,"FL",559715,12103,277450,6056,276209,"D",0.498879274065806,"ages 15-34",207820,104107,103713,79432,78602,15888,16106,518,437,4307,4441,3790,3992,89154,89306,14953,14407,24675,25111
"78","FLORIDA","PINELLAS",2020,"FL",559715,12103,277450,6056,276209,"D",0.498879274065806,"ages 35-64",389339,187227,202112,158813,167805,18046,21268,855,851,6819,8994,2454,2912,168316,182510,18911,19602,28414,34307
"79","FLORIDA","PINELLAS",2020,"FL",559715,12103,277450,6056,276209,"D",0.498879274065806,"ages 65+",253295,112844,140451,103640,127873,5663,8057,283,325,2458,3315,738,828,107835,133832,5009,6619,9204,12578
"80","FLORIDA","PINELLAS",2020,"FL",559715,12103,277450,6056,276209,"D",0.498879274065806,"total",976802,468464,508338,387015,417757,51346,56878,1963,1916,16250,19239,11303,11939,419046,457240,49418,51098,81449,90581
"81","FLORIDA","SEMINOLE",2016,"FL",224896,12117,105914,9539,109443,"R",0.508193371935902,"ages 15-34",123169,62057,61112,47941,46681,8895,9182,353,317,2936,2890,1848,1943,46772,46179,15285,14933,14116,14431
"82","FLORIDA","SEMINOLE",2016,"FL",224896,12117,105914,9539,109443,"R",0.508193371935902,"ages 35-64",186554,89101,97453,73927,79167,9413,11518,380,419,3906,4768,1374,1469,72322,78383,16779,19070,15174,18286
"83","FLORIDA","SEMINOLE",2016,"FL",224896,12117,105914,9539,109443,"R",0.508193371935902,"ages 65+",67502,29141,38361,25438,33399,2393,3291,90,97,945,1232,259,320,25724,33358,3417,5003,3703,4962
"84","FLORIDA","SEMINOLE",2016,"FL",224896,12117,105914,9539,109443,"R",0.508193371935902,"total",456266,220410,235856,176619,187708,26988,30028,995,986,9797,10871,5744,5962,174857,186917,45553,48939,43791,48148
"85","FLORIDA","SEMINOLE",2020,"FL",260815,12117,132528,3046,125241,"D",0.485865251446062,"ages 15-34",124990,62922,62068,47147,46017,9737,10043,364,358,3328,3293,2264,2286,46367,45687,16555,16381,15775,16051
"86","FLORIDA","SEMINOLE",2020,"FL",260815,12117,132528,3046,125241,"D",0.485865251446062,"ages 35-64",191194,92192,99002,74777,78604,10357,12700,406,457,4844,5366,1694,1743,71591,76590,20601,22412,17415,20398
"87","FLORIDA","SEMINOLE",2020,"FL",260815,12117,132528,3046,125241,"D",0.485865251446062,"ages 65+",77457,33339,44118,28710,37833,2890,4091,119,127,1243,1613,351,421,28870,37668,4469,6450,4629,6285
"88","FLORIDA","SEMINOLE",2020,"FL",260815,12117,132528,3046,125241,"D",0.485865251446062,"total",474171,229394,244777,179691,190785,29570,33238,1123,1136,11819,12455,6901,6860,176768,188823,52626,55954,49703,53992
"89","GEORGIA","BURKE",2016,"GA",9351,13033,4731,129,4491,"D",0.486987638256344,"ages 15-34",5625,2763,2862,1271,1212,1421,1573,8,10,13,15,46,48,2650,2783,113,79,1492,1650
"90","GEORGIA","BURKE",2016,"GA",9351,13033,4731,129,4491,"D",0.486987638256344,"ages 35-64",8767,4124,4643,2316,2361,1724,2210,21,12,19,23,38,33,3975,4533,149,110,1808,2282
"91","GEORGIA","BURKE",2016,"GA",9351,13033,4731,129,4491,"D",0.486987638256344,"ages 65+",3270,1409,1861,937,1065,451,766,8,8,6,8,7,14,1385,1840,24,21,472,796
"92","GEORGIA","BURKE",2016,"GA",9351,13033,4731,129,4491,"D",0.486987638256344,"total",22638,10835,11803,5607,5596,4958,5905,47,36,57,60,152,194,10448,11481,387,322,5228,6207
"93","GEORGIA","BURKE",2020,"GA",10684,13033,5209,75,5400,"R",0.509001790932227,"ages 15-34",5629,2785,2844,1305,1220,1406,1528,10,19,13,17,44,54,2694,2758,91,86,1480,1624
"94","GEORGIA","BURKE",2020,"GA",10684,13033,5209,75,5400,"R",0.509001790932227,"ages 35-64",8466,3981,4485,2268,2316,1620,2074,26,15,23,33,38,43,3803,4355,178,130,1713,2169
"95","GEORGIA","BURKE",2020,"GA",10684,13033,5209,75,5400,"R",0.509001790932227,"ages 65+",3830,1672,2158,1047,1215,589,907,12,9,10,8,12,18,1641,2121,31,37,625,943
"96","GEORGIA","BURKE",2020,"GA",10684,13033,5209,75,5400,"R",0.509001790932227,"total",22648,10770,11878,5611,5768,4837,5753,69,55,69,70,168,219,10355,11506,415,372,5159,6110
"97","IDAHO","TETON",2016,"ID",4976,16081,2159,650,2167,"R",0.500924641701341,"ages 15-34",2719,1461,1258,1425,1207,7,7,8,12,3,9,14,19,1124,1009,337,249,36,51
"98","IDAHO","TETON",2016,"ID",4976,16081,2159,650,2167,"R",0.500924641701341,"ages 35-64",4832,2526,2306,2457,2234,9,9,17,18,12,19,26,21,2191,1992,335,314,69,72
"99","IDAHO","TETON",2016,"ID",4976,16081,2159,650,2167,"R",0.500924641701341,"ages 65+",1155,603,552,593,544,0,0,4,1,1,2,5,5,577,534,26,18,10,8
"100","IDAHO","TETON",2016,"ID",4976,16081,2159,650,2167,"R",0.500924641701341,"total",11179,5863,5316,5704,5124,19,24,45,53,22,39,63,65,4895,4444,968,872,159,192
"101","IDAHO","TETON",2020,"ID",6347,16081,3318,171,2858,"D",0.462759067357513,"ages 15-34",2910,1577,1333,1523,1270,13,9,12,14,9,12,16,25,1197,1041,380,292,54,63
"102","IDAHO","TETON",2020,"ID",6347,16081,3318,171,2858,"D",0.462759067357513,"ages 35-64",5513,2863,2650,2775,2558,13,14,19,16,16,24,37,34,2474,2288,389,362,88,92
"103","IDAHO","TETON",2020,"ID",6347,16081,3318,171,2858,"D",0.462759067357513,"ages 65+",1641,853,788,838,772,0,0,6,6,3,2,6,7,807,767,46,21,15,16
"104","IDAHO","TETON",2020,"ID",6347,16081,3318,171,2858,"D",0.462759067357513,"total",12501,6526,5975,6311,5734,31,30,57,60,35,51,84,90,5419,5022,1107,953,215,241
"105","ILLINOIS","KENDALL",2016,"IL",53447,17093,24884,3602,24961,"R",0.50077239442271,"ages 15-34",32305,16118,16187,13884,13855,1358,1304,104,100,400,525,358,394,12282,12552,3836,3635,2234,2332
"106","ILLINOIS","KENDALL",2016,"IL",53447,17093,24884,3602,24961,"R",0.50077239442271,"ages 35-64",50056,24719,25337,21801,22161,1733,1857,130,117,822,947,224,241,20938,21691,3781,3646,2918,3176
"107","ILLINOIS","KENDALL",2016,"IL",53447,17093,24884,3602,24961,"R",0.50077239442271,"ages 65+",11926,5338,6588,4997,6135,163,222,21,17,137,176,20,36,4989,6131,349,457,341,453
"108","ILLINOIS","KENDALL",2016,"IL",53447,17093,24884,3602,24961,"R",0.50077239442271,"total",124549,61761,62788,53952,54652,4388,4428,315,297,1823,2122,1250,1251,50399,51824,11362,10964,7809,8136
"109","ILLINOIS","KENDALL",2020,"IL",63974,17093,33168,1314,29492,"D",0.470667092243856,"ages 15-34",33697,17079,16618,14333,13814,1603,1585,140,126,514,607,470,474,12398,12364,4681,4254,2746,2804
"110","ILLINOIS","KENDALL",2020,"IL",63974,17093,33168,1314,29492,"D",0.470667092243856,"ages 35-64",53053,26362,26691,22698,22829,2184,2291,161,174,994,1103,308,276,21352,22011,5010,4680,3664,3862
"111","ILLINOIS","KENDALL",2020,"IL",63974,17093,33168,1314,29492,"D",0.470667092243856,"ages 65+",14407,6330,8077,5814,7353,257,370,25,32,200,264,34,51,5838,7398,492,679,516,724
"112","ILLINOIS","KENDALL",2020,"IL",63974,17093,33168,1314,29492,"D",0.470667092243856,"total",130638,64783,65855,55259,55964,5342,5529,415,413,2220,2457,1494,1436,50757,52584,14026,13271,9524,9891
"113","ILLINOIS","MCLEAN",2016,"IL",79835,17113,36196,6402,37237,"R",0.507088093908733,"ages 15-34",59506,29014,30492,23372,24912,2653,2795,98,101,2072,1893,796,780,27318,28811,1696,1681,5642,5580
"114","ILLINOIS","MCLEAN",2016,"IL",79835,17113,36196,6402,37237,"R",0.507088093908733,"ages 35-64",60851,29850,31001,25721,26941,2079,2226,88,78,1649,1440,297,303,28655,29955,1195,1046,4129,4060
"115","ILLINOIS","MCLEAN",2016,"IL",79835,17113,36196,6402,37237,"R",0.507088093908733,"ages 65+",21213,9391,11822,8865,11183,290,375,20,25,175,169,40,68,9274,11681,117,141,526,639
"116","ILLINOIS","MCLEAN",2016,"IL",79835,17113,36196,6402,37237,"R",0.507088093908733,"total",173157,84260,88897,70176,74842,6634,6962,320,306,5028,4654,2045,2097,80017,84787,4243,4110,14084,14055
"117","ILLINOIS","MCLEAN",2020,"IL",87002,17113,43933,2567,40502,"D",0.479682596079825,"ages 15-34",57821,28073,29748,22653,24186,2773,3050,85,94,1644,1515,902,888,26284,27891,1789,1857,5420,5562
"118","ILLINOIS","MCLEAN",2020,"IL",87002,17113,43933,2567,40502,"D",0.479682596079825,"ages 35-64",59133,29021,30112,24749,25900,2197,2353,87,83,1649,1429,326,330,27729,28923,1292,1189,4272,4212
"119","ILLINOIS","MCLEAN",2020,"IL",87002,17113,43933,2567,40502,"D",0.479682596079825,"ages 65+",24364,10801,13563,10129,12739,413,506,27,26,169,210,58,78,10631,13376,170,187,672,824
"120","ILLINOIS","MCLEAN",2020,"IL",87002,17113,43933,2567,40502,"D",0.479682596079825,"total",171256,83022,88234,68997,74006,7100,7607,299,302,4401,4118,2174,2154,78540,83778,4482,4456,14025,14228
"121","INDIANA","TIPPECANOE",2016,"IN",62515,18157,27282,4465,30768,"R",0.530025839793282,"ages 15-34",79929,43568,36361,33297,29171,2215,2392,136,99,6922,3945,968,726,40562,33512,3006,2849,10271,7190
"122","INDIANA","TIPPECANOE",2016,"IN",62515,18157,27282,4465,30768,"R",0.530025839793282,"ages 35-64",56915,28177,28738,25146,25596,1217,1114,119,132,1425,1597,252,290,25956,26802,2221,1936,3031,3142
"123","INDIANA","TIPPECANOE",2016,"IN",62515,18157,27282,4465,30768,"R",0.530025839793282,"ages 65+",20580,8997,11583,8590,11107,142,172,28,24,183,207,52,73,8803,11383,194,200,407,476
"124","INDIANA","TIPPECANOE",2016,"IN",62515,18157,27282,4465,30768,"R",0.530025839793282,"total",190475,97502,92973,80721,79021,4941,5077,349,330,9373,6626,2064,1876,89511,85551,7991,7422,16781,13952
"125","INDIANA","TIPPECANOE",2020,"IN",71448,18157,35017,1850,34581,"D",0.496867726084083,"ages 15-34",80657,43856,36801,33330,29074,2543,2828,148,123,6659,3879,1149,861,40245,33538,3611,3263,10526,7727
"126","INDIANA","TIPPECANOE",2020,"IN",71448,18157,35017,1850,34581,"D",0.496867726084083,"ages 35-64",58440,28919,29521,25331,25868,1482,1447,126,128,1653,1750,306,316,26309,27182,2610,2339,3588,3653
"127","INDIANA","TIPPECANOE",2020,"IN",71448,18157,35017,1850,34581,"D",0.496867726084083,"ages 65+",23936,10558,13378,10031,12721,185,217,31,35,236,310,74,94,10286,13082,272,296,527,657
"128","INDIANA","TIPPECANOE",2020,"IN",71448,18157,35017,1850,34581,"D",0.496867726084083,"total",196115,100092,96023,81898,80514,5875,6175,393,376,9415,6809,2448,2088,90989,87690,9103,8333,18194,15509
"129","KANSAS","JOHNSON",2016,"KS",290090,20091,129852,22748,137490,"R",0.514285073052495,"ages 15-34",152524,77005,75519,64294,63259,4806,4635,415,425,5057,4752,2367,2418,69820,68539,7185,6980,12711,12260
"130","KANSAS","JOHNSON",2016,"KS",290090,20091,129852,22748,137490,"R",0.514285073052495,"ages 35-64",233743,113875,119868,101104,106352,5481,5368,471,440,5474,6282,1288,1389,106792,112774,7083,7094,12771,13516
"131","KANSAS","JOHNSON",2016,"KS",290090,20091,129852,22748,137490,"R",0.514285073052495,"ages 65+",79664,35013,44651,33219,42330,666,987,33,74,923,1074,164,180,34257,43622,756,1029,1794,2321
"132","KANSAS","JOHNSON",2016,"KS",290090,20091,129852,22748,137490,"R",0.514285073052495,"total",586601,287564,299037,249868,260949,14431,14350,1157,1169,14792,15140,7168,7339,265372,277159,22192,21878,37696,38088
"133","KANSAS","JOHNSON",2020,"KS",347214,20091,184259,7324,155631,"D",0.457886375003678,"ages 15-34",156703,79884,76819,65860,63748,5047,4533,453,493,5454,5025,3019,2979,71480,68903,8404,7916,14024,13071
"134","KANSAS","JOHNSON",2020,"KS",347214,20091,184259,7324,155631,"D",0.457886375003678,"ages 35-64",237618,116235,121383,101952,106546,5965,5913,479,418,6249,6936,1532,1529,108124,113178,8111,8205,14283,14837
"135","KANSAS","JOHNSON",2020,"KS",347214,20091,184259,7324,155631,"D",0.457886375003678,"ages 65+",94102,41727,52375,39422,49363,894,1212,50,108,1151,1457,198,227,40695,51033,1032,1342,2305,3012
"136","KANSAS","JOHNSON",2020,"KS",347214,20091,184259,7324,155631,"D",0.457886375003678,"total",607220,298222,308998,256948,267764,15352,15034,1224,1274,16383,16588,8170,8224,273654,284630,24568,24368,41274,41234
"137","KANSAS","RILEY",2016,"KS",21532,20161,9341,2084,10107,"R",0.519693541752365,"ages 15-34",40407,23008,17399,18875,14369,1932,1194,149,144,1293,1041,687,621,21046,15901,1962,1498,4133,3030
"138","KANSAS","RILEY",2016,"KS",21532,20161,9341,2084,10107,"R",0.519693541752365,"ages 35-64",17665,8812,8853,7550,7581,652,486,71,73,357,544,146,152,8222,8194,590,659,1262,1272
"139","KANSAS","RILEY",2016,"KS",21532,20161,9341,2084,10107,"R",0.519693541752365,"ages 65+",6518,2936,3582,2781,3370,73,79,7,10,52,97,18,24,2888,3501,48,81,155,212
"140","KANSAS","RILEY",2016,"KS",21532,20161,9341,2084,10107,"R",0.519693541752365,"total",75374,40276,35098,33427,29415,3119,2199,298,277,1967,1937,1322,1200,36946,32283,3330,2815,6849,5683
"141","KANSAS","RILEY",2020,"KS",25171,20161,12765,796,11610,"D",0.476307692307692,"ages 15-34",36930,20444,16486,16786,13727,1632,1049,148,126,1070,878,753,674,18575,15055,1869,1431,3658,2759
"142","KANSAS","RILEY",2020,"KS",25171,20161,12765,796,11610,"D",0.476307692307692,"ages 35-64",18371,9123,9248,7808,7844,660,533,71,73,371,577,173,205,8414,8496,709,752,1315,1404
"143","KANSAS","RILEY",2020,"KS",25171,20161,12765,796,11610,"D",0.476307692307692,"ages 65+",7541,3428,4113,3208,3823,109,115,16,15,57,131,30,26,3361,4002,67,111,220,290
"144","KANSAS","RILEY",2020,"KS",25171,20161,12765,796,11610,"D",0.476307692307692,"total",73202,38309,34893,31865,29283,2848,2131,281,261,1750,1814,1435,1332,34937,31971,3372,2922,6444,5610
"145","KANSAS","SHAWNEE",2016,"KS",75406,20177,33926,5546,35934,"R",0.514371600343544,"ages 15-34",44902,22315,22587,18102,18193,2184,2251,356,369,494,536,1139,1205,18890,19254,3425,3333,4213,4394
"146","KANSAS","SHAWNEE",2016,"KS",75406,20177,33926,5546,35934,"R",0.514371600343544,"ages 35-64",67507,32641,34866,28317,30251,2795,2796,430,485,463,571,597,734,29572,31797,3069,3069,4324,4615
"147","KANSAS","SHAWNEE",2016,"KS",75406,20177,33926,5546,35934,"R",0.514371600343544,"ages 65+",30426,13364,17062,12355,15736,683,924,109,104,117,173,89,115,12700,16303,664,759,1009,1326
"148","KANSAS","SHAWNEE",2016,"KS",75406,20177,33926,5546,35934,"R",0.514371600343544,"total",178413,86454,91959,72694,77496,7564,7830,1236,1300,1304,1499,3547,3736,75583,81217,10871,10742,13760,14463
"149","KANSAS","SHAWNEE",2020,"KS",85657,20177,43015,2199,40443,"D",0.484591051786527,"ages 15-34",43597,21708,21889,17445,17415,2122,2192,331,379,394,473,1377,1388,18088,18211,3620,3678,4263,4474
"150","KANSAS","SHAWNEE",2020,"KS",85657,20177,43015,2199,40443,"D",0.484591051786527,"ages 35-64",64819,31186,33633,27039,29062,2593,2649,395,484,498,576,622,830,27829,30189,3357,3444,4147,4571
"151","KANSAS","SHAWNEE",2020,"KS",85657,20177,43015,2199,40443,"D",0.484591051786527,"ages 65+",33963,14998,18965,13784,17407,817,1030,107,122,143,234,136,161,14183,18044,815,921,1214,1558
"152","KANSAS","SHAWNEE",2020,"KS",85657,20177,43015,2199,40443,"D",0.484591051786527,"total",175999,85095,90904,71380,76360,7364,7622,1176,1310,1259,1496,3806,4003,73589,79307,11506,11597,13715,14544
"153","MAINE","KENNEBEC",2016,"ME",66208,23011,29302,5231,31675,"R",0.519458156354035,"ages 15-34",28699,14425,14274,13561,13434,214,114,93,79,225,325,320,312,14086,13989,339,285,864,840
"154","MAINE","KENNEBEC",2016,"ME",66208,23011,29302,5231,31675,"R",0.519458156354035,"ages 35-64",50835,24680,26155,23902,25385,199,108,135,158,167,221,271,274,24427,25873,253,282,778,770
"155","MAINE","KENNEBEC",2016,"ME",66208,23011,29302,5231,31675,"R",0.519458156354035,"ages 65+",22580,10289,12291,10145,12111,29,23,24,29,30,49,59,78,10251,12225,38,66,144,180
"156","MAINE","KENNEBEC",2016,"ME",66208,23011,29302,5231,31675,"R",0.519458156354035,"total",121538,59344,62194,56917,59825,533,326,311,314,503,677,1056,1029,58448,61282,896,912,2427,2369
"157","MAINE","KENNEBEC",2020,"ME",72615,23011,34902,2992,34721,"D",0.49870014219439,"ages 15-34",29043,14727,14316,13752,13425,225,138,96,76,234,311,403,360,14339,13966,388,350,975,891
"158","MAINE","KENNEBEC",2020,"ME",72615,23011,34902,2992,34721,"D",0.49870014219439,"ages 35-64",49096,23825,25271,22946,24457,248,120,167,166,171,232,290,285,23495,24908,330,363,879,814
"159","MAINE","KENNEBEC",2020,"ME",72615,23011,34902,2992,34721,"D",0.49870014219439,"ages 65+",25621,11667,13954,11474,13703,44,33,34,43,37,69,74,105,11610,13868,57,86,193,251
"160","MAINE","KENNEBEC",2020,"ME",72615,23011,34902,2992,34721,"D",0.49870014219439,"total",122955,59926,63029,57180,60421,604,389,365,342,533,688,1216,1170,58874,61942,1052,1087,2746,2608
"161","MARYLAND","FREDERICK",2016,"MD",125677,24021,56522,9633,59522,"R",0.512926131467374,"ages 15-34",63095,31944,31151,25734,24916,3627,3306,158,141,1366,1581,1017,1170,28266,27700,3678,3451,6210,6235
"162","MARYLAND","FREDERICK",2016,"MD",125677,24021,56522,9633,59522,"R",0.512926131467374,"ages 35-64",102871,50559,52312,42428,43814,4889,4755,256,235,2289,2691,650,777,46522,48578,4037,3734,8131,8498
"163","MARYLAND","FREDERICK",2016,"MD",125677,24021,56522,9633,59522,"R",0.512926131467374,"ages 65+",34073,15021,19052,13652,17270,798,1099,31,51,423,499,111,129,14649,18502,372,550,1369,1782
"164","MARYLAND","FREDERICK",2016,"MD",125677,24021,56522,9633,59522,"R",0.512926131467374,"total",247269,121686,125583,100058,103243,12111,11910,588,589,5320,6021,3488,3707,110309,114700,11377,10883,21628,22340
"165","MARYLAND","FREDERICK",2020,"MD",145615,24021,77675,4258,63682,"D",0.45050475038378,"ages 15-34",66195,33621,32574,26061,25265,4308,3965,183,155,1680,1726,1361,1430,29277,28333,4344,4241,7560,7309
"166","MARYLAND","FREDERICK",2020,"MD",145615,24021,77675,4258,63682,"D",0.45050475038378,"ages 35-64",107935,53335,54600,43199,44098,6205,5891,290,263,2800,3367,780,939,47802,49533,5533,5067,10136,10502
"167","MARYLAND","FREDERICK",2020,"MD",145615,24021,77675,4258,63682,"D",0.45050475038378,"ages 65+",40522,18006,22516,16180,20156,1027,1399,49,64,582,708,161,181,17446,21682,560,834,1826,2360
"168","MARYLAND","FREDERICK",2020,"MD",145615,24021,77675,4258,63682,"D",0.45050475038378,"total",265161,130696,134465,104071,107541,14903,14528,731,677,6630,7322,4231,4277,116005,120266,14691,14199,26625,26924
"169","MARYLAND","KENT",2016,"MD",10021,24029,4575,570,4876,"R",0.515924240821077,"ages 15-34",4977,2456,2521,1933,2023,386,375,13,6,67,56,56,60,2297,2390,159,131,523,498
"170","MARYLAND","KENT",2016,"MD",10021,24029,4575,570,4876,"R",0.515924240821077,"ages 35-64",7017,3347,3670,2780,2985,501,602,13,7,23,38,29,37,3146,3558,201,112,567,685
"171","MARYLAND","KENT",2016,"MD",10021,24029,4575,570,4876,"R",0.515924240821077,"ages 65+",5075,2278,2797,1999,2386,256,372,3,4,12,20,6,14,2257,2770,21,27,279,411
"172","MARYLAND","KENT",2016,"MD",10021,24029,4575,570,4876,"R",0.515924240821077,"total",19708,9397,10311,7662,8336,1411,1619,32,21,118,133,168,197,8909,9929,488,382,1735,1975
"173","MARYLAND","KENT",2020,"MD",10794,24029,5329,270,5195,"D",0.493633599391866,"ages 15-34",4765,2366,2399,1856,1927,342,336,16,13,81,48,70,74,2211,2275,155,124,510,472
"174","MARYLAND","KENT",2020,"MD",10794,24029,5329,270,5195,"D",0.493633599391866,"ages 35-64",6773,3275,3498,2721,2850,486,559,11,10,25,42,31,35,3043,3375,232,123,554,648
"175","MARYLAND","KENT",2020,"MD",10794,24029,5329,270,5195,"D",0.493633599391866,"ages 65+",5254,2357,2897,2079,2489,242,360,7,5,16,25,11,17,2334,2870,23,27,278,408
"176","MARYLAND","KENT",2020,"MD",10794,24029,5329,270,5195,"D",0.493633599391866,"total",19192,9193,9999,7496,8132,1319,1486,46,33,134,131,193,212,8663,9623,530,376,1697,1867
"177","MARYLAND","TALBOT",2016,"MD",20553,24041,8653,1176,10724,"R",0.553439644939877,"ages 15-34",7210,3621,3589,2871,2818,601,584,10,22,62,74,69,83,3282,3272,339,317,750,771
"178","MARYLAND","TALBOT",2016,"MD",20553,24041,8653,1176,10724,"R",0.553439644939877,"ages 35-64",13914,6446,7468,5414,6273,836,992,30,23,88,121,71,54,6057,7086,389,382,1032,1195
"179","MARYLAND","TALBOT",2016,"MD",20553,24041,8653,1176,10724,"R",0.553439644939877,"ages 65+",10401,4632,5769,4183,5176,394,542,10,5,24,24,20,20,4575,5699,57,70,449,593
"180","MARYLAND","TALBOT",2016,"MD",20553,24041,8653,1176,10724,"R",0.553439644939877,"total",37170,17548,19622,14668,16342,2229,2572,59,69,232,295,318,310,16353,18426,1195,1196,2880,3280
"181","MARYLAND","TALBOT",2020,"MD",22555,24041,11062,547,10946,"D",0.497364594692839,"ages 15-34",7005,3497,3508,2743,2735,580,564,11,22,58,85,96,95,3220,3152,277,356,754,773
"182","MARYLAND","TALBOT",2020,"MD",22555,24041,11062,547,10946,"D",0.497364594692839,"ages 35-64",13227,6159,7068,5136,5914,801,926,39,25,98,117,75,78,5713,6622,446,446,1023,1154
"183","MARYLAND","TALBOT",2020,"MD",22555,24041,11062,547,10946,"D",0.497364594692839,"ages 65+",11265,5004,6261,4494,5575,431,616,14,8,34,33,29,26,4931,6182,73,79,510,686
"184","MARYLAND","TALBOT",2020,"MD",22555,24041,11062,547,10946,"D",0.497364594692839,"total",36972,17499,19473,14545,16167,2207,2529,79,75,248,308,371,359,16207,18124,1292,1349,2954,3306
"185","MICHIGAN","KENT",2016,"MI",308184,26081,138683,21321,148180,"R",0.516553197867972,"ages 15-34",189106,94997,94109,75852,75429,11513,10916,861,766,3479,3565,3205,3362,83190,83141,11807,10968,19145,18680
"186","MICHIGAN","KENT",2016,"MI",308184,26081,138683,21321,148180,"R",0.516553197867972,"ages 35-64",240270,118483,121787,102102,103321,10667,11926,858,861,3278,3874,1481,1707,108721,112549,9762,9238,16381,18466
"187","MICHIGAN","KENT",2016,"MI",308184,26081,138683,21321,148180,"R",0.516553197867972,"ages 65+",82617,36157,46460,33144,42214,2026,2962,98,127,693,870,181,271,34999,45003,1158,1457,3013,4246
"188","MICHIGAN","KENT",2016,"MI",308184,26081,138683,21321,148180,"R",0.516553197867972,"total",644219,317509,326710,262613,269784,33159,34316,2348,2350,9688,10415,9436,9603,283095,293680,34414,33030,54896,56926
"189","MICHIGAN","KENT",2020,"MI",361048,26081,187915,7392,165741,"D",0.46865032687131,"ages 15-34",191980,96834,95146,76151,75224,12196,11330,846,836,3681,3847,3855,3850,83879,82647,12955,12499,20683,19922
"190","MICHIGAN","KENT",2020,"MI",361048,26081,187915,7392,165741,"D",0.46865032687131,"ages 35-64",241079,119099,121980,101337,102524,11191,12080,896,856,3858,4438,1717,1983,108152,111668,10947,10312,17762,19456
"191","MICHIGAN","KENT",2020,"MI",361048,26081,187915,7392,165741,"D",0.46865032687131,"ages 65+",95704,42603,53101,38892,47851,2497,3608,122,143,800,1118,265,358,41086,51263,1517,1838,3711,5250
"192","MICHIGAN","KENT",2020,"MI",361048,26081,187915,7392,165741,"D",0.46865032687131,"total",658708,325207,333501,266289,273211,34978,35568,2364,2391,10739,11561,10531,10519,288268,297639,36939,35862,58918,60290
"193","MICHIGAN","LEELANAU",2016,"MI",14757,26089,6774,744,7239,"R",0.516591736244915,"ages 15-34",3925,1998,1927,1800,1667,19,17,115,124,19,26,42,92,1855,1776,143,151,198,260
"194","MICHIGAN","LEELANAU",2016,"MI",14757,26089,6774,744,7239,"R",0.516591736244915,"ages 35-64",8446,4098,4348,3912,4111,17,18,115,148,13,17,41,54,3965,4243,133,105,186,237
"195","MICHIGAN","LEELANAU",2016,"MI",14757,26089,6774,744,7239,"R",0.516591736244915,"ages 65+",6272,3013,3259,2957,3179,3,12,30,38,6,11,17,19,2985,3234,28,25,56,80
"196","MICHIGAN","LEELANAU",2016,"MI",14757,26089,6774,744,7239,"R",0.516591736244915,"total",21508,10577,10931,9945,10141,52,67,368,419,56,69,153,233,10137,10512,440,419,632,790
"197","MICHIGAN","LEELANAU",2020,"MI",16900,26089,8795,189,7916,"D",0.473699958111424,"ages 15-34",3740,1915,1825,1726,1589,24,23,99,103,15,23,47,86,1756,1660,159,165,189,236
"198","MICHIGAN","LEELANAU",2020,"MI",16900,26089,8795,189,7916,"D",0.473699958111424,"ages 35-64",8034,3879,4155,3670,3911,20,25,122,137,14,18,52,62,3727,4034,152,121,209,244
"199","MICHIGAN","LEELANAU",2020,"MI",16900,26089,8795,189,7916,"D",0.473699958111424,"ages 65+",7238,3502,3736,3425,3632,9,12,37,59,10,16,20,17,3466,3698,36,38,77,104
"200","MICHIGAN","LEELANAU",2020,"MI",16900,26089,8795,189,7916,"D",0.473699958111424,"total",21743,10673,11070,9994,10291,64,81,357,382,61,69,190,239,10199,10615,474,455,679,779
"201","MICHIGAN","SAGINAW",2016,"MI",94320,26145,44396,4455,45469,"R",0.505970066210427,"ages 15-34",49848,25202,24646,18301,17559,5511,5620,172,137,474,555,732,755,22774,22115,2428,2531,6901,7087
"202","MICHIGAN","SAGINAW",2016,"MI",94320,26145,44396,4455,45469,"R",0.505970066210427,"ages 35-64",73556,35485,38071,28734,29949,5782,7065,181,217,461,467,310,356,33213,35486,2272,2585,6751,8122
"203","MICHIGAN","SAGINAW",2016,"MI",94320,26145,44396,4455,45469,"R",0.505970066210427,"ages 65+",35236,15409,19827,13168,16824,1979,2696,45,59,116,144,92,97,14688,18926,721,901,2241,3003
"204","MICHIGAN","SAGINAW",2016,"MI",94320,26145,44396,4455,45469,"R",0.505970066210427,"total",192636,93578,99058,71880,75224,17649,19606,519,519,1276,1375,2208,2279,85582,90663,7996,8395,21698,23834
"205","MICHIGAN","SAGINAW",2020,"MI",103349,26145,51088,1476,50785,"D",0.498512854240083,"ages 15-34",48919,24714,24205,17848,17165,5423,5495,172,147,426,472,827,910,21978,21569,2736,2636,6866,7040
"206","MICHIGAN","SAGINAW",2020,"MI",103349,26145,51088,1476,50785,"D",0.498512854240083,"ages 35-64",69491,33805,35686,27242,27901,5530,6673,185,214,491,493,342,388,31507,33090,2298,2596,6563,7785
"207","MICHIGAN","SAGINAW",2020,"MI",103349,26145,51088,1476,50785,"D",0.498512854240083,"ages 65+",38240,16728,21512,14191,18033,2216,3096,60,82,143,164,109,127,15907,20481,821,1031,2537,3479
"208","MICHIGAN","SAGINAW",2020,"MI",103349,26145,51088,1476,50785,"D",0.498512854240083,"total",189868,92304,97564,70521,73761,17478,19349,543,545,1279,1341,2430,2509,83931,88877,8373,8687,21783,23803
"209","MINNESOTA","BLUE EARTH",2016,"MN",33593,27013,14428,3498,15667,"R",0.520584814753281,"ages 15-34",25912,13349,12563,11717,11231,718,581,41,48,601,419,266,271,12722,12097,627,466,1632,1332
"210","MINNESOTA","BLUE EARTH",2016,"MN",33593,27013,14428,3498,15667,"R",0.520584814753281,"ages 35-64",20735,10474,10261,9934,9717,276,232,49,39,152,204,56,67,10171,10024,303,237,540,544
"211","MINNESOTA","BLUE EARTH",2016,"MN",33593,27013,14428,3498,15667,"R",0.520584814753281,"ages 65+",8765,3901,4864,3817,4784,33,28,6,6,37,34,8,12,3871,4820,30,44,84,80
"212","MINNESOTA","BLUE EARTH",2016,"MN",33593,27013,14428,3498,15667,"R",0.520584814753281,"total",66398,33468,32930,30461,30291,1390,1166,121,115,868,729,611,608,32174,31901,1294,1029,3007,2639
"213","MINNESOTA","BLUE EARTH",2020,"MN",36051,27013,18330,990,16731,"D",0.477196885428254,"ages 15-34",25811,13127,12684,11309,11161,793,683,64,50,613,414,336,364,12381,12127,746,557,1818,1523
"214","MINNESOTA","BLUE EARTH",2020,"MN",36051,27013,18330,990,16731,"D",0.477196885428254,"ages 35-64",21080,10642,10438,9931,9706,405,370,55,42,162,223,79,90,10236,10141,406,297,711,732
"215","MINNESOTA","BLUE EARTH",2020,"MN",36051,27013,18330,990,16731,"D",0.477196885428254,"ages 65+",10057,4563,5494,4428,5377,67,34,6,12,46,55,16,16,4507,5444,56,50,135,117
"216","MINNESOTA","BLUE EARTH",2020,"MN",36051,27013,18330,990,16731,"D",0.477196885428254,"total",68241,34217,34024,30605,30823,1703,1485,165,128,931,785,787,779,32641,32802,1576,1222,3612,3201
"217","MINNESOTA","CLAY",2016,"MN",29398,27027,12971,2884,13543,"R",0.51078675416761,"ages 15-34",20786,10211,10575,9102,9437,494,378,162,212,225,223,214,317,9690,10084,521,491,1109,1138
"218","MINNESOTA","CLAY",2016,"MN",29398,27027,12971,2884,13543,"R",0.51078675416761,"ages 35-64",21364,10782,10582,10088,10084,267,150,145,133,130,111,148,98,10434,10250,348,332,694,498
"219","MINNESOTA","CLAY",2016,"MN",29398,27027,12971,2884,13543,"R",0.51078675416761,"ages 65+",8050,3550,4500,3471,4415,18,12,21,20,29,32,10,20,3508,4468,42,32,79,85
"220","MINNESOTA","CLAY",2016,"MN",29398,27027,12971,2884,13543,"R",0.51078675416761,"total",63090,31115,31975,28302,29374,1114,824,541,549,433,444,702,765,29696,30573,1419,1402,2813,2601
"221","MINNESOTA","CLAY",2020,"MN",32239,27027,16357,839,15043,"D",0.479076433121019,"ages 15-34",20314,9876,10438,8596,9040,655,561,148,204,198,249,267,379,9334,9891,542,547,1280,1398
"222","MINNESOTA","CLAY",2020,"MN",32239,27027,16357,839,15043,"D",0.479076433121019,"ages 35-64",21807,11076,10731,10156,9999,447,330,162,155,144,119,158,119,10685,10352,391,379,920,732
"223","MINNESOTA","CLAY",2020,"MN",32239,27027,16357,839,15043,"D",0.479076433121019,"ages 65+",8975,4072,4903,3943,4790,38,20,32,34,35,27,23,31,4014,4846,58,57,129,113
"224","MINNESOTA","CLAY",2020,"MN",32239,27027,16357,839,15043,"D",0.479076433121019,"total",64690,32013,32677,28425,29306,1683,1430,585,574,447,482,845,866,30454,31116,1559,1561,3588,3371
"225","MINNESOTA","NICOLLET",2016,"MN",18097,27103,7886,1774,8437,"R",0.516878024872879,"ages 15-34",10053,5099,4954,4652,4523,214,180,40,18,103,136,86,96,4801,4732,298,222,447,431
"226","MINNESOTA","NICOLLET",2016,"MN",18097,27103,7886,1774,8437,"R",0.516878024872879,"ages 35-64",12368,6363,6005,6005,5736,199,136,51,18,74,77,34,37,6130,5811,233,194,358,269
"227","MINNESOTA","NICOLLET",2016,"MN",18097,27103,7886,1774,8437,"R",0.516878024872879,"ages 65+",5125,2381,2744,2345,2702,11,10,6,3,13,19,6,10,2359,2723,22,21,36,42
"228","MINNESOTA","NICOLLET",2016,"MN",18097,27103,7886,1774,8437,"R",0.516878024872879,"total",33766,17006,16760,15784,15608,581,515,117,54,241,293,277,285,16245,16075,761,685,1222,1152
"229","MINNESOTA","NICOLLET",2020,"MN",19125,27103,9622,485,9018,"D",0.483798283261803,"ages 15-34",10005,5017,4988,4504,4425,247,281,31,23,128,126,105,131,4680,4717,337,271,513,563
"230","MINNESOTA","NICOLLET",2020,"MN",19125,27103,9622,485,9018,"D",0.483798283261803,"ages 35-64",12499,6465,6034,6020,5664,261,199,63,31,79,92,42,48,6159,5804,306,230,445,370
"231","MINNESOTA","NICOLLET",2020,"MN",19125,27103,9622,485,9018,"D",0.483798283261803,"ages 65+",5775,2702,3073,2652,3019,18,12,8,3,18,28,6,11,2670,3038,32,35,50,54
"232","MINNESOTA","NICOLLET",2020,"MN",19125,27103,9622,485,9018,"D",0.483798283261803,"total",34482,17323,17159,15938,15703,728,732,125,76,262,294,267,350,16393,16350,930,809,1385,1456
"233","MINNESOTA","WINONA",2016,"MN",26074,27169,11366,2586,12122,"R",0.516093324250681,"ages 15-34",18088,8987,9101,8113,8295,232,193,51,31,482,451,109,129,8651,8810,336,291,874,806
"234","MINNESOTA","WINONA",2016,"MN",26074,27169,11366,2586,12122,"R",0.516093324250681,"ages 35-64",17229,8756,8473,8478,8165,104,81,35,38,98,128,39,58,8549,8333,207,140,278,308
"235","MINNESOTA","WINONA",2016,"MN",26074,27169,11366,2586,12122,"R",0.516093324250681,"ages 65+",8058,3691,4367,3643,4316,4,2,8,3,22,36,14,10,3657,4338,34,29,48,51
"236","MINNESOTA","WINONA",2016,"MN",26074,27169,11366,2586,12122,"R",0.516093324250681,"total",50912,25260,25652,23693,24090,448,417,120,85,670,698,327,357,24460,24992,800,660,1567,1562
"237","MINNESOTA","WINONA",2020,"MN",27173,27169,13333,613,13227,"D",0.498004518072289,"ages 15-34",17166,8538,8628,7675,7838,228,196,48,29,464,421,123,141,8194,8332,344,296,863,790
"238","MINNESOTA","WINONA",2020,"MN",27173,27169,13333,613,13227,"D",0.498004518072289,"ages 35-64",16754,8442,8312,8134,7965,112,114,34,44,108,131,51,54,8200,8133,242,179,308,347
"239","MINNESOTA","WINONA",2020,"MN",27173,27169,13333,613,13227,"D",0.498004518072289,"ages 65+",9218,4307,4911,4236,4834,14,8,6,9,33,42,18,18,4265,4878,42,33,71,77
"240","MINNESOTA","WINONA",2020,"MN",27173,27169,13333,613,13227,"D",0.498004518072289,"total",50485,25037,25448,23411,23861,474,454,123,99,675,666,351,361,24155,24722,882,726,1626,1587
"241","MISSISSIPPI","WARREN",2016,"MS",19416,28149,9284,365,9767,"R",0.512676499921264,"ages 15-34",11792,5692,6100,2526,2486,3050,3493,24,18,38,46,52,56,5545,5942,147,158,3166,3614
"242","MISSISSIPPI","WARREN",2016,"MS",19416,28149,9284,365,9767,"R",0.512676499921264,"ages 35-64",18470,8740,9730,4635,4747,3929,4789,38,33,78,105,57,54,8595,9565,145,165,4105,4983
"243","MISSISSIPPI","WARREN",2016,"MS",19416,28149,9284,365,9767,"R",0.512676499921264,"ages 65+",7299,3165,4134,2153,2635,948,1432,13,11,27,43,22,13,3131,4099,34,35,1012,1499
"244","MISSISSIPPI","WARREN",2016,"MS",19416,28149,9284,365,9767,"R",0.512676499921264,"total",47017,22389,24628,11257,11685,10644,12426,84,75,174,224,223,214,21934,24134,455,494,11132,12943
"245","MISSISSIPPI","WARREN",2020,"MS",21053,28149,10442,246,10365,"D",0.498149661171721,"ages 15-34",10900,5303,5597,2377,2320,2810,3153,18,16,39,50,58,55,5172,5464,131,133,2926,3277
"246","MISSISSIPPI","WARREN",2020,"MS",21053,28149,10442,246,10365,"D",0.498149661171721,"ages 35-64",17095,8071,9024,4162,4248,3749,4613,38,32,69,76,49,53,7880,8864,191,160,3909,4776
"247","MISSISSIPPI","WARREN",2020,"MS",21053,28149,10442,246,10365,"D",0.498149661171721,"ages 65+",8068,3530,4538,2286,2745,1173,1708,19,18,25,51,25,16,3487,4489,43,49,1244,1793
"248","MISSISSIPPI","WARREN",2020,"MS",21053,28149,10442,246,10365,"D",0.498149661171721,"total",44841,21391,23450,10697,11010,10218,11919,81,78,164,202,224,235,20904,22981,487,469,10694,12440
"249","MONTANA","BLAINE",2016,"MT",2684,30005,1202,214,1268,"R",0.51336032388664,"ages 15-34",1711,867,844,317,325,2,3,520,498,6,1,22,17,826,821,41,23,550,519
"250","MONTANA","BLAINE",2016,"MT",2684,30005,1202,214,1268,"R",0.51336032388664,"ages 35-64",2323,1191,1132,678,608,6,1,473,494,4,1,30,27,1126,1113,65,19,513,524
"251","MONTANA","BLAINE",2016,"MT",2684,30005,1202,214,1268,"R",0.51336032388664,"ages 65+",978,430,548,325,378,1,0,97,160,1,0,6,10,426,541,4,7,105,170
"252","MONTANA","BLAINE",2016,"MT",2684,30005,1202,214,1268,"R",0.51336032388664,"total",6716,3360,3356,1610,1596,10,5,1647,1660,11,6,82,88,3220,3275,140,81,1750,1760
"253","MONTANA","BLAINE",2020,"MT",3117,30005,1589,59,1469,"D",0.480379332897318,"ages 15-34",1686,880,806,299,283,3,3,548,495,5,2,25,23,833,782,47,24,581,523
"254","MONTANA","BLAINE",2020,"MT",3117,30005,1589,59,1469,"D",0.480379332897318,"ages 35-64",2194,1116,1078,591,544,7,3,484,497,3,1,31,32,1049,1055,67,23,525,534
"255","MONTANA","BLAINE",2020,"MT",3117,30005,1589,59,1469,"D",0.480379332897318,"ages 65+",1049,468,581,336,376,2,1,120,192,1,0,9,12,464,574,4,7,132,205
"256","MONTANA","BLAINE",2020,"MT",3117,30005,1589,59,1469,"D",0.480379332897318,"total",6568,3302,3266,1487,1477,17,9,1701,1677,9,6,88,96,3149,3187,153,79,1815,1789
"257","NEW HAMPSHIRE","CARROLL",2016,"NH",29616,33003,12987,1994,14635,"R",0.52983129389617,"ages 15-34",8743,4494,4249,4321,4097,47,35,25,10,23,39,75,67,4404,4152,90,97,173,152
"258","NEW HAMPSHIRE","CARROLL",2016,"NH",29616,33003,12987,1994,14635,"R",0.52983129389617,"ages 35-64",19993,9732,10261,9525,9980,42,36,26,44,46,103,89,93,9646,10137,86,124,207,281
"259","NEW HAMPSHIRE","CARROLL",2016,"NH",29616,33003,12987,1994,14635,"R",0.52983129389617,"ages 65+",12528,6113,6415,6019,6337,15,7,16,16,31,25,31,29,6084,6380,29,35,94,78
"260","NEW HAMPSHIRE","CARROLL",2016,"NH",29616,33003,12987,1994,14635,"R",0.52983129389617,"total",47527,23650,23877,23012,23239,129,105,78,84,119,190,304,252,23349,23532,301,345,638,638
"261","NEW HAMPSHIRE","CARROLL",2020,"NH",33221,33003,16649,422,16150,"D",0.492393060764048,"ages 15-34",8767,4545,4222,4341,4035,63,49,16,13,43,51,79,74,4434,4112,111,110,204,187
"262","NEW HAMPSHIRE","CARROLL",2020,"NH",33221,33003,16649,422,16150,"D",0.492393060764048,"ages 35-64",19792,9581,10211,9337,9898,60,57,40,43,58,104,83,103,9451,10044,130,167,244,313
"263","NEW HAMPSHIRE","CARROLL",2020,"NH",33221,33003,16649,422,16150,"D",0.492393060764048,"ages 65+",14571,7103,7468,6978,7343,21,16,22,24,40,39,41,45,7070,7429,33,39,125,125
"264","NEW HAMPSHIRE","CARROLL",2020,"NH",33221,33003,16649,422,16150,"D",0.492393060764048,"total",49167,24373,24794,23612,24019,176,163,91,97,165,216,322,292,23995,24385,378,409,761,775
"265","NEW HAMPSHIRE","HILLSBOROUGH",2016,"NH",214157,33011,99589,14555,100013,"R",0.501062113606076,"ages 15-34",107093,54989,52104,48416,45977,1949,1721,202,147,3046,2891,1322,1327,50141,47581,4848,4523,6573,6127
"266","NEW HAMPSHIRE","HILLSBOROUGH",2016,"NH",214157,33011,99589,14555,100013,"R",0.501062113606076,"ages 35-64",173303,86371,86932,79280,80383,2475,1798,253,250,3393,3575,922,882,82214,82771,4157,4161,7091,6549
"267","NEW HAMPSHIRE","HILLSBOROUGH",2016,"NH",214157,33011,99589,14555,100013,"R",0.501062113606076,"ages 65+",60661,27106,33555,25992,32300,292,293,61,47,601,744,154,165,26541,32848,565,707,1114,1255
"268","NEW HAMPSHIRE","HILLSBOROUGH",2016,"NH",214157,33011,99589,14555,100013,"R",0.501062113606076,"total",411591,204630,206961,184599,187981,6334,5270,664,563,8857,9052,4035,3976,190976,193777,13654,13184,20031,18980
"269","NEW HAMPSHIRE","HILLSBOROUGH",2020,"NH",230941,33011,122344,3972,104625,"D",0.460966035009186,"ages 15-34",109991,56815,53176,49244,46454,2435,2124,218,185,3223,2832,1640,1534,51070,47918,5745,5258,7571,6722
"270","NEW HAMPSHIRE","HILLSBOROUGH",2020,"NH",230941,33011,122344,3972,104625,"D",0.460966035009186,"ages 35-64",170864,85255,85609,77032,78208,3058,2206,296,236,3743,3935,1069,976,79893,80563,5362,5046,8223,7401
"271","NEW HAMPSHIRE","HILLSBOROUGH",2020,"NH",230941,33011,122344,3972,104625,"D",0.460966035009186,"ages 65+",69907,31549,38358,30153,36648,377,384,76,65,743,1026,190,227,30842,37440,707,918,1396,1710
"272","NEW HAMPSHIRE","HILLSBOROUGH",2020,"NH",230941,33011,122344,3972,104625,"D",0.460966035009186,"total",418735,208477,210258,185813,189186,7667,6330,760,588,9557,9627,4522,4386,191980,194754,16497,15504,22664,21072
"273","NEW HAMPSHIRE","ROCKINGHAM",2016,"NH",181434,33015,79994,10993,90447,"R",0.530664570144508,"ages 15-34",70795,36542,34253,34356,32113,522,383,135,88,791,998,715,654,34867,32949,1675,1304,2186,2140
"274","NEW HAMPSHIRE","ROCKINGHAM",2016,"NH",181434,33015,79994,10993,90447,"R",0.530664570144508,"ages 35-64",134826,66500,68326,63711,65494,733,492,147,144,1310,1659,577,504,65041,66818,1459,1508,2789,2832
"275","NEW HAMPSHIRE","ROCKINGHAM",2016,"NH",181434,33015,79994,10993,90447,"R",0.530664570144508,"ages 65+",50391,23013,27378,22506,26814,125,122,35,27,229,298,117,115,22848,27117,165,261,507,564
"276","NEW HAMPSHIRE","ROCKINGHAM",2016,"NH",181434,33015,79994,10993,90447,"R",0.530664570144508,"total",304748,150892,153856,143521,146519,1709,1268,358,307,2941,3568,2310,2128,146436,149687,4456,4169,7371,7337
"277","NEW HAMPSHIRE","ROCKINGHAM",2020,"NH",198798,33015,100064,2876,95858,"D",0.489266136523719,"ages 15-34",72155,37322,34833,34873,32505,576,414,125,90,840,1053,884,750,35363,33287,1959,1546,2449,2328
"278","NEW HAMPSHIRE","ROCKINGHAM",2020,"NH",198798,33015,100064,2876,95858,"D",0.489266136523719,"ages 35-64",132499,65419,67080,62153,63760,1002,633,156,159,1452,1905,617,592,63331,65165,2088,1915,3266,3320
"279","NEW HAMPSHIRE","ROCKINGHAM",2020,"NH",198798,33015,100064,2876,95858,"D",0.489266136523719,"ages 65+",59581,27344,32237,26673,31476,160,161,48,45,305,402,152,145,27096,31884,248,353,671,761
"280","NEW HAMPSHIRE","ROCKINGHAM",2020,"NH",198798,33015,100064,2876,95858,"D",0.489266136523719,"total",311307,154153,157154,145846,148916,2105,1503,388,348,3243,3996,2491,2309,148539,152132,5614,5022,8307,8238
"281","NEW HAMPSHIRE","SULLIVAN",2016,"NH",22683,33019,10210,1677,10796,"R",0.513948395696468,"ages 15-34",9207,4688,4519,4492,4308,52,39,19,26,49,59,73,87,4566,4427,122,92,196,211
"282","NEW HAMPSHIRE","SULLIVAN",2016,"NH",22683,33019,10210,1677,10796,"R",0.513948395696468,"ages 35-64",18362,9149,9213,8868,8945,77,48,43,34,51,90,109,94,9049,9121,100,92,281,268
"283","NEW HAMPSHIRE","SULLIVAN",2016,"NH",22683,33019,10210,1677,10796,"R",0.513948395696468,"ages 65+",8735,4011,4724,3941,4644,11,11,10,5,11,29,38,35,3993,4703,18,21,70,80
"284","NEW HAMPSHIRE","SULLIVAN",2016,"NH",22683,33019,10210,1677,10796,"R",0.513948395696468,"total",43088,21246,21842,20499,21069,169,127,81,78,148,245,345,319,20908,21539,338,303,747,773
"285","NEW HAMPSHIRE","SULLIVAN",2020,"NH",24380,33019,12390,482,11508,"D",0.481546572934974,"ages 15-34",9335,4843,4492,4606,4232,67,25,22,24,68,110,77,100,4693,4378,150,114,237,260
"286","NEW HAMPSHIRE","SULLIVAN",2020,"NH",24380,33019,12390,482,11508,"D",0.481546572934974,"ages 35-64",17633,8755,8878,8431,8574,96,51,52,47,69,103,106,102,8609,8743,146,135,324,304
"287","NEW HAMPSHIRE","SULLIVAN",2020,"NH",24380,33019,12390,482,11508,"D",0.481546572934974,"ages 65+",9913,4598,5315,4483,5219,19,15,10,6,26,36,60,39,4572,5288,26,27,115,96
"288","NEW HAMPSHIRE","SULLIVAN",2020,"NH",24380,33019,12390,482,11508,"D",0.481546572934974,"total",43267,21468,21799,20546,20930,218,122,101,90,194,277,402,376,21046,21414,422,385,922,869
"289","NEW JERSEY","GLOUCESTER",2016,"NJ",139542,34015,66870,5128,67544,"R",0.502507179311679,"ages 15-34",73868,37496,36372,30774,29494,4515,4591,119,106,1127,1211,924,944,34451,33604,3045,2768,6722,6878
"290","NEW JERSEY","GLOUCESTER",2016,"NJ",139542,34015,66870,5128,67544,"R",0.502507179311679,"ages 35-64",120662,57966,62696,50022,53055,5608,6770,138,144,1598,1985,565,711,55228,59838,2738,2858,7944,9641
"291","NEW JERSEY","GLOUCESTER",2016,"NJ",139542,34015,66870,5128,67544,"R",0.502507179311679,"ages 65+",43527,18918,24609,16838,21627,1461,2193,49,56,452,605,111,122,18539,24148,379,461,2080,2982
"292","NEW JERSEY","GLOUCESTER",2016,"NJ",139542,34015,66870,5128,67544,"R",0.502507179311679,"total",290795,141278,149517,118819,124400,14895,16744,383,410,4050,4628,3024,3243,132491,140919,8787,8598,22459,25117
"293","NEW JERSEY","GLOUCESTER",2020,"NJ",172654,34015,86702,2612,83340,"D",0.490114207078251,"ages 15-34",74178,37927,36251,30464,28958,4930,4848,140,92,1249,1234,1104,1091,34431,33032,3496,3219,7463,7293
"294","NEW JERSEY","GLOUCESTER",2020,"NJ",172654,34015,86702,2612,83340,"D",0.490114207078251,"ages 35-64",118859,57150,61709,48676,51572,5887,7033,147,155,1728,2121,665,786,53720,58176,3430,3533,8474,10137
"295","NEW JERSEY","GLOUCESTER",2020,"NJ",172654,34015,86702,2612,83340,"D",0.490114207078251,"ages 65+",49177,21524,27653,19021,24076,1729,2578,63,71,559,759,143,161,20958,26985,566,668,2503,3577
"296","NEW JERSEY","GLOUCESTER",2020,"NJ",172654,34015,86702,2612,83340,"D",0.490114207078251,"total",293245,142639,150606,118258,123922,15992,17692,460,420,4408,4904,3397,3557,132284,140409,10355,10197,24381,26684
"297","NEW JERSEY","MORRIS",2016,"NJ",250416,34027,115249,9096,126071,"R",0.522422509530913,"ages 15-34",116230,59516,56714,48960,46329,2721,2497,256,205,6187,6356,1345,1298,49448,47831,10068,8883,10556,10385
"298","NEW JERSEY","MORRIS",2016,"NJ",250416,34027,115249,9096,126071,"R",0.522422509530913,"ages 35-64",211538,103664,107874,88088,90649,3756,4000,287,278,10543,11784,956,1127,90527,94513,13137,13361,15576,17225
"299","NEW JERSEY","MORRIS",2016,"NJ",250416,34027,115249,9096,126071,"R",0.522422509530913,"ages 65+",80269,35038,45231,31260,40527,785,1267,46,49,2756,3109,186,270,33291,42857,1747,2374,3778,4704
"300","NEW JERSEY","MORRIS",2016,"NJ",250416,34027,115249,9096,126071,"R",0.522422509530913,"total",493831,242385,251446,203352,210606,8842,9221,781,742,24883,26294,4413,4486,210155,219925,32230,31521,39033,40840
"301","NEW JERSEY","MORRIS",2020,"NJ",299322,34027,153881,4307,141134,"D",0.478396013762012,"ages 15-34",116424,59595,56829,48355,45980,2802,2555,197,175,6589,6541,1617,1542,49702,47618,9893,9211,11240,10849
"302","NEW JERSEY","MORRIS",2020,"NJ",299322,34027,153881,4307,141134,"D",0.478396013762012,"ages 35-64",205352,101225,104127,84149,85774,4082,4170,354,345,11514,12595,1082,1196,86608,89571,14617,14556,17076,18353
"303","NEW JERSEY","MORRIS",2020,"NJ",299322,34027,153881,4307,141134,"D",0.478396013762012,"ages 65+",88146,39050,49096,34465,43386,903,1450,59,68,3374,3858,239,326,36704,45996,2346,3100,4585,5710
"304","NEW JERSEY","MORRIS",2020,"NJ",299322,34027,153881,4307,141134,"D",0.478396013762012,"total",491087,241679,249408,199321,205680,9599,9755,861,810,26949,28122,4814,4909,207136,215293,34543,34115,42358,43728
"305","NEW YORK","BROOME",2016,"NY",86072,36007,39212,5917,40943,"R",0.510797829205914,"ages 15-34",56638,29064,27574,23344,21886,2282,2331,54,80,2460,2294,900,953,27388,25891,1676,1683,5720,5688
"306","NEW YORK","BROOME",2016,"NY",86072,36007,39212,5917,40943,"R",0.510797829205914,"ages 35-64",71215,35211,36004,31923,32657,1739,1679,107,106,942,1097,486,449,34278,35070,933,934,3288,3347
"307","NEW YORK","BROOME",2016,"NY",86072,36007,39212,5917,40943,"R",0.510797829205914,"ages 65+",35702,15403,20299,14659,19514,344,332,30,24,272,313,95,112,15224,20101,179,198,744,785
"308","NEW YORK","BROOME",2016,"NY",86072,36007,39212,5917,40943,"R",0.510797829205914,"total",194575,95719,98856,82722,85892,5790,5735,222,265,4199,4155,2724,2750,91667,94879,4052,3977,12997,12964
"309","NEW YORK","BROOME",2020,"NY",93494,36007,47010,2684,43800,"D",0.482325735051206,"ages 15-34",54811,28295,26516,22330,20685,2513,2453,52,72,2314,2200,1060,1082,26431,24730,1864,1786,5965,5831
"310","NEW YORK","BROOME",2020,"NY",93494,36007,47010,2684,43800,"D",0.482325735051206,"ages 35-64",67092,33024,34068,29474,30369,1840,1885,119,112,1040,1152,536,526,31987,32976,1037,1092,3550,3699
"311","NEW YORK","BROOME",2020,"NY",93494,36007,47010,2684,43800,"D",0.482325735051206,"ages 65+",37570,16572,20998,15667,19998,413,429,34,31,333,392,119,144,16330,20734,242,264,905,1000
"312","NEW YORK","BROOME",2020,"NY",93494,36007,47010,2684,43800,"D",0.482325735051206,"total",189420,93377,96043,79517,82298,6217,6222,253,256,4264,4240,3055,2967,88919,91685,4458,4358,13860,13745
"313","NEW YORK","ESSEX",2016,"NY",17218,36031,7762,1498,7958,"R",0.506234096692112,"ages 15-34",8522,4821,3701,4102,3523,518,41,74,15,54,56,71,65,4390,3623,431,78,719,178
"314","NEW YORK","ESSEX",2016,"NY",17218,36031,7762,1498,7958,"R",0.506234096692112,"ages 35-64",15881,8214,7667,7586,7492,425,30,55,25,50,58,92,59,7883,7563,331,104,628,175
"315","NEW YORK","ESSEX",2016,"NY",17218,36031,7762,1498,7958,"R",0.506234096692112,"ages 65+",8289,3903,4386,3835,4311,18,9,9,13,11,19,30,33,3876,4352,27,34,68,75
"316","NEW YORK","ESSEX",2016,"NY",17218,36031,7762,1498,7958,"R",0.506234096692112,"total",37695,19520,18175,17986,17625,984,106,146,60,123,149,270,229,18646,17891,874,284,1534,550
"317","NEW YORK","ESSEX",2020,"NY",19470,36031,9947,547,8976,"D",0.474343391639803,"ages 15-34",8024,4551,3473,3899,3312,470,34,63,20,42,45,73,60,4137,3363,414,110,652,161
"318","NEW YORK","ESSEX",2020,"NY",19470,36031,9947,547,8976,"D",0.474343391639803,"ages 35-64",15016,7770,7246,7180,7063,400,33,46,26,54,71,83,51,7446,7124,324,122,590,183
"319","NEW YORK","ESSEX",2020,"NY",19470,36031,9947,547,8976,"D",0.474343391639803,"ages 65+",9243,4395,4848,4296,4749,23,15,18,17,16,16,42,48,4355,4807,40,41,99,99
"320","NEW YORK","ESSEX",2020,"NY",19470,36031,9947,547,8976,"D",0.474343391639803,"total",36891,19033,17858,17560,17278,913,110,140,70,125,150,282,241,18184,17519,849,339,1473,580
"321","NEW YORK","RENSSELAER",2016,"NY",71562,36083,32717,5119,33726,"R",0.50759297442921,"ages 15-34",44168,23126,21042,19028,17380,2099,2069,94,82,1178,870,711,630,21724,19634,1402,1408,4098,3662
"322","NEW YORK","RENSSELAER",2016,"NY",71562,36083,32717,5119,33726,"R",0.50759297442921,"ages 35-64",63426,30795,32631,27959,29383,1786,2105,107,104,616,644,315,387,29823,31523,972,1108,2836,3248
"323","NEW YORK","RENSSELAER",2016,"NY",71562,36083,32717,5119,33726,"R",0.50759297442921,"ages 65+",25728,11373,14355,10837,13639,335,464,31,24,91,151,75,70,11238,14191,135,164,536,716
"324","NEW YORK","RENSSELAER",2016,"NY",71562,36083,32717,5119,33726,"R",0.50759297442921,"total",159311,78581,80730,68201,70291,5810,6174,269,253,2278,2021,1979,1959,74792,76818,3789,3912,10380,10439
"325","NEW YORK","RENSSELAER",2020,"NY",79962,36083,40969,2493,36500,"D",0.471156204417251,"ages 15-34",42940,22326,20614,18075,16565,2185,2306,83,78,1176,866,790,791,20750,19089,1576,1525,4251,4049
"326","NEW YORK","RENSSELAER",2020,"NY",79962,36083,40969,2493,36500,"D",0.471156204417251,"ages 35-64",61477,29925,31552,26697,27991,2029,2315,90,106,749,730,344,394,28738,30174,1187,1378,3228,3561
"327","NEW YORK","RENSSELAER",2020,"NY",79962,36083,40969,2493,36500,"D",0.471156204417251,"ages 65+",28589,12874,15715,12192,14870,427,535,52,36,106,181,93,87,12695,15501,179,214,682,845
"328","NEW YORK","RENSSELAER",2020,"NY",79962,36083,40969,2493,36500,"D",0.471156204417251,"total",158108,78077,80031,66967,68796,6250,6668,255,276,2440,2138,2113,2113,73920,75666,4157,4365,11110,11235
"329","NEW YORK","SARATOGA",2016,"NY",114094,36091,50913,8606,54575,"R",0.51735742454118,"ages 15-34",54806,28370,26436,25722,24168,780,588,99,68,978,990,761,611,26996,25255,1374,1181,2648,2268
"330","NEW YORK","SARATOGA",2016,"NY",114094,36091,50913,8606,54575,"R",0.51735742454118,"ages 35-64",95568,47130,48438,44419,45923,893,710,124,105,1223,1270,461,413,45885,47310,1245,1128,2711,2515
"331","NEW YORK","SARATOGA",2016,"NY",114094,36091,50913,8606,54575,"R",0.51735742454118,"ages 65+",38722,17450,21272,16992,20692,125,178,31,32,203,262,97,105,17283,21070,167,202,458,580
"332","NEW YORK","SARATOGA",2016,"NY",114094,36091,50913,8606,54575,"R",0.51735742454118,"total",227189,112404,114785,104571,107457,2177,1850,299,247,3094,3198,2204,1990,108671,111390,3733,3395,7833,7328
"333","NEW YORK","SARATOGA",2020,"NY",133556,36091,68471,3780,61305,"D",0.472390888916286,"ages 15-34",54470,27824,26646,25170,24107,816,741,94,72,850,974,870,744,26393,25449,1431,1197,2654,2539
"334","NEW YORK","SARATOGA",2020,"NY",133556,36091,68471,3780,61305,"D",0.472390888916286,"ages 35-64",94627,46646,47981,43640,45103,1045,834,114,110,1353,1427,473,485,45183,46588,1463,1393,3006,2878
"335","NEW YORK","SARATOGA",2020,"NY",133556,36091,68471,3780,61305,"D",0.472390888916286,"ages 65+",44681,20319,24362,19680,23607,194,214,46,38,258,361,138,139,20082,24067,237,295,639,755
"336","NEW YORK","SARATOGA",2020,"NY",133556,36091,68471,3780,61305,"D",0.472390888916286,"total",230298,113444,116854,104986,108667,2561,2279,309,274,3195,3402,2321,2182,109317,113052,4127,3802,8458,8187
"337","NORTH CAROLINA","NASH",2016,"NC",47665,37127,23235,1111,23319,"R",0.500902178115737,"ages 15-34",23120,11611,11509,5836,5619,5184,5355,147,136,167,152,245,241,10563,10523,1048,986,5775,5890
"338","NORTH CAROLINA","NASH",2016,"NC",47665,37127,23235,1111,23319,"R",0.500902178115737,"ages 35-64",37538,17935,19603,10617,10715,6798,8331,168,197,171,171,173,185,16888,18773,1047,830,7318,8888
"339","NORTH CAROLINA","NASH",2016,"NC",47665,37127,23235,1111,23319,"R",0.500902178115737,"ages 65+",16328,6954,9374,4910,6228,1924,2994,40,38,40,51,38,63,6842,9257,112,117,2044,3146
"340","NORTH CAROLINA","NASH",2016,"NC",47665,37127,23235,1111,23319,"R",0.500902178115737,"total",94060,45181,48879,25756,26742,17650,20318,444,480,502,492,778,827,41847,45841,3334,3038,19425,22137
"341","NORTH CAROLINA","NASH",2020,"NC",52271,37127,25947,497,25827,"D",0.498841117163055,"ages 15-34",23643,11858,11785,5795,5623,5414,5535,157,163,179,124,283,333,10698,10693,1160,1092,6063,6162
"342","NORTH CAROLINA","NASH",2020,"NC",52271,37127,25947,497,25827,"D",0.498841117163055,"ages 35-64",36155,17218,18937,9825,9988,6863,8365,175,179,188,205,154,193,16054,17961,1164,976,7393,8949
"343","NORTH CAROLINA","NASH",2020,"NC",52271,37127,25947,497,25827,"D",0.498841117163055,"ages 65+",18188,7775,10413,5266,6546,2359,3683,49,65,47,56,51,62,7623,10256,152,157,2509,3867
"344","NORTH CAROLINA","NASH",2020,"NC",52271,37127,25947,497,25827,"D",0.498841117163055,"total",94859,45345,49514,24972,26144,18460,21312,503,530,537,510,817,994,41708,46099,3637,3415,20373,23370
"345","NORTH CAROLINA","NEW HANOVER",2016,"NC",111905,37129,50979,5582,55344,"R",0.52052707316385,"ages 15-34",66975,32413,34562,26371,27890,4498,4869,186,194,582,700,741,850,30330,32623,2083,1939,6042,6672
"346","NORTH CAROLINA","NEW HANOVER",2016,"NC",111905,37129,50979,5582,55344,"R",0.52052707316385,"ages 35-64",85238,40627,44611,34248,36605,5117,6452,208,252,563,753,450,520,38722,42877,1905,1734,6379,8006
"347","NORTH CAROLINA","NEW HANOVER",2016,"NC",111905,37129,50979,5582,55344,"R",0.52052707316385,"ages 65+",37466,16306,21160,14401,18339,1657,2513,51,58,107,145,79,99,16086,20875,220,285,1905,2821
"348","NORTH CAROLINA","NEW HANOVER",2016,"NC",111905,37129,50979,5582,55344,"R",0.52052707316385,"total",224922,107333,117589,88280,95462,14640,17083,570,694,1514,1874,2212,2343,101155,111568,6178,6021,19053,22127
"349","NORTH CAROLINA","NEW HANOVER",2020,"NC",131830,37129,66138,2361,63331,"D",0.489159567155072,"ages 15-34",67333,32698,34635,26585,28040,4433,4661,188,203,569,653,895,1029,30485,32358,2213,2277,6113,6595
"350","NORTH CAROLINA","NEW HANOVER",2020,"NC",131830,37129,66138,2361,63331,"D",0.489159567155072,"ages 35-64",89375,42383,46992,35992,39044,4971,6171,238,267,636,829,495,638,40140,44799,2243,2193,6391,7948
"351","NORTH CAROLINA","NEW HANOVER",2020,"NC",131830,37129,66138,2361,63331,"D",0.489159567155072,"ages 65+",44982,19491,25491,17207,21990,1956,3016,57,83,147,231,110,159,19177,25079,314,412,2284,3501
"352","NORTH CAROLINA","NEW HANOVER",2020,"NC",131830,37129,66138,2361,63331,"D",0.489159567155072,"total",236613,112364,124249,93005,101707,14461,16871,645,755,1625,1959,2492,2800,105347,117078,7017,7171,19359,22542
"353","NORTH CAROLINA","SCOTLAND",2016,"NC",13928,37165,7319,353,6256,"D",0.460847145488029,"ages 15-34",9115,4783,4332,1895,1772,2091,1766,641,638,42,43,109,113,4574,4205,209,127,2888,2560
"354","NORTH CAROLINA","SCOTLAND",2016,"NC",13928,37165,7319,353,6256,"D",0.460847145488029,"ages 35-64",13441,6722,6719,3203,3195,2635,2582,737,763,63,81,80,94,6526,6601,196,118,3519,3524
"355","NORTH CAROLINA","SCOTLAND",2016,"NC",13928,37165,7319,353,6256,"D",0.460847145488029,"ages 65+",6039,2569,3470,1586,2045,793,1134,162,254,7,8,21,29,2538,3435,31,35,983,1425
"356","NORTH CAROLINA","SCOTLAND",2016,"NC",13928,37165,7319,353,6256,"D",0.460847145488029,"total",35315,17544,17771,7923,8080,6936,6912,2084,2200,157,152,433,421,16937,17302,607,469,9621,9691
"357","NORTH CAROLINA","SCOTLAND",2020,"NC",14775,37165,7186,116,7473,"R",0.509789207995088,"ages 15-34",8814,4692,4122,1779,1641,2020,1685,703,621,51,43,133,130,4509,3986,183,136,2913,2481
"358","NORTH CAROLINA","SCOTLAND",2020,"NC",14775,37165,7186,116,7473,"R",0.509789207995088,"ages 35-64",12453,6295,6158,2984,2848,2427,2361,736,783,62,77,80,85,6083,6030,212,128,3311,3310
"359","NORTH CAROLINA","SCOTLAND",2020,"NC",14775,37165,7186,116,7473,"R",0.509789207995088,"ages 65+",6571,2776,3795,1615,2149,926,1288,198,295,13,19,24,44,2738,3755,38,40,1161,1646
"360","NORTH CAROLINA","SCOTLAND",2020,"NC",14775,37165,7186,116,7473,"R",0.509789207995088,"total",34637,17183,17454,7553,7730,6753,6755,2204,2301,165,165,494,493,16514,16911,669,543,9630,9724
"361","OHIO","LORAIN",2016,"OH",140562,39093,66949,6795,66818,"D",0.499510342610659,"ages 15-34",73502,37694,35808,30712,29489,4637,3804,161,155,660,724,1501,1592,32816,31122,4878,4686,6982,6319
"362","OHIO","LORAIN",2016,"OH",140562,39093,66949,6795,66818,"D",0.499510342610659,"ages 35-64",124176,61338,62838,54479,56425,5255,4489,225,245,608,821,737,831,56801,58183,4537,4655,6859,6413
"363","OHIO","LORAIN",2016,"OH",140562,39093,66949,6795,66818,"D",0.499510342610659,"ages 65+",52959,23262,29697,21664,27589,1219,1613,57,70,191,261,120,151,22163,28441,1099,1256,1598,2108
"364","OHIO","LORAIN",2016,"OH",140562,39093,66949,6795,66818,"D",0.499510342610659,"total",306676,151079,155597,129809,135210,14445,13068,555,578,1785,2134,4387,4491,136095,140662,14984,14935,21270,20387
"365","OHIO","LORAIN",2020,"OH",157437,39093,75667,2250,79520,"R",0.512414055301024,"ages 15-34",74300,38301,35999,30926,29430,4744,3796,145,144,664,754,1805,1835,33025,30826,5276,5173,7375,6569
"366","OHIO","LORAIN",2020,"OH",157437,39093,75667,2250,79520,"R",0.512414055301024,"ages 35-64",121973,60127,61846,53177,55168,5096,4540,226,230,773,941,817,927,54993,56712,5134,5134,6950,6678
"367","OHIO","LORAIN",2020,"OH",157437,39093,75667,2250,79520,"R",0.512414055301024,"ages 65+",60480,26863,33617,24923,31119,1458,1833,78,100,218,353,172,197,25464,31978,1399,1639,1940,2498
"368","OHIO","LORAIN",2020,"OH",157437,39093,75667,2250,79520,"R",0.512414055301024,"total",312172,153762,158410,131430,136956,14666,13259,579,596,2045,2408,4937,5059,137360,141974,16402,16436,22332,21454
"369","OHIO","MAHONING",2016,"OH",115072,39099,57381,4075,53616,"D",0.483040082164383,"ages 15-34",54890,28308,26582,21553,20009,5513,5309,71,88,328,311,821,848,25792,24749,2516,1833,6755,6573
"370","OHIO","MAHONING",2016,"OH",115072,39099,57381,4075,53616,"D",0.483040082164383,"ages 35-64",91420,44904,46516,38097,38567,5801,6871,160,121,374,435,452,499,42341,44657,2563,1859,6807,7949
"371","OHIO","MAHONING",2016,"OH",115072,39099,57381,4075,53616,"D",0.483040082164383,"ages 65+",46033,19617,26416,17456,23081,1922,3026,32,50,101,122,102,136,19166,25874,451,542,2161,3335
"372","OHIO","MAHONING",2016,"OH",115072,39099,57381,4075,53616,"D",0.483040082164383,"total",230263,112291,117972,90881,94702,17532,19258,302,295,971,1082,2549,2585,104999,112072,7292,5900,21410,23270
"373","OHIO","MAHONING",2020,"OH",118966,39099,57641,1422,59903,"R",0.509621928809637,"ages 15-34",54385,28534,25851,21407,19258,5716,5176,70,88,320,316,993,997,25529,23776,3005,2075,7127,6593
"374","OHIO","MAHONING",2020,"OH",118966,39099,57641,1422,59903,"R",0.509621928809637,"ages 35-64",84784,41794,42990,35257,35561,5427,6327,179,120,408,416,504,542,38688,40877,3106,2113,6537,7429
"375","OHIO","MAHONING",2020,"OH",118966,39099,57641,1422,59903,"R",0.509621928809637,"ages 65+",49996,21751,28245,19315,24567,2156,3284,46,65,112,147,115,165,21167,27572,584,673,2436,3678
"376","OHIO","MAHONING",2020,"OH",118966,39099,57641,1422,59903,"R",0.509621928809637,"total",226075,111016,115059,89128,91938,17527,18776,343,320,1015,1072,2926,2880,102335,108389,8681,6670,21888,23121
"377","OHIO","MONTGOMERY",2016,"OH",258301,39113,122016,12376,123909,"R",0.503848734370235,"ages 15-34",141204,70499,70705,50409,49307,15476,16963,218,171,2085,1849,2246,2374,67775,68209,2724,2496,20090,21398
"378","OHIO","MONTGOMERY",2016,"OH",258301,39113,122016,12376,123909,"R",0.503848734370235,"ages 35-64",201173,96643,104530,74717,77890,18358,22183,320,267,1996,2530,1208,1599,94350,102345,2293,2185,21926,26640
"379","OHIO","MONTGOMERY",2016,"OH",258301,39113,122016,12376,123909,"R",0.503848734370235,"ages 65+",91955,38913,53042,32090,42495,6025,9288,58,93,516,795,212,359,38590,52587,323,455,6823,10547
"380","OHIO","MONTGOMERY",2016,"OH",258301,39113,122016,12376,123909,"R",0.503848734370235,"total",532274,256229,276045,190247,200807,52548,60576,737,653,5622,6436,6925,7420,248485,268727,7744,7318,65982,75238
"381","OHIO","MONTGOMERY",2020,"OH",268505,39113,135064,4407,129034,"D",0.488583783292566,"ages 15-34",142000,71318,70682,50107,48493,16109,17249,195,198,2076,1906,2763,2796,68107,67618,3211,3064,21211,22189
"382","OHIO","MONTGOMERY",2020,"OH",268505,39113,135064,4407,129034,"D",0.488583783292566,"ages 35-64",193805,93031,100774,71189,74231,17933,21890,307,259,2273,2627,1274,1702,90311,98080,2720,2694,21842,26543
"383","OHIO","MONTGOMERY",2020,"OH",268505,39113,135064,4407,129034,"D",0.488583783292566,"ages 65+",98808,42027,56781,34427,45029,6659,10224,95,117,578,988,254,404,41593,56227,434,554,7600,11752
"384","OHIO","MONTGOMERY",2020,"OH",268505,39113,135064,4407,129034,"D",0.488583783292566,"total",531610,255914,275696,187851,198041,53336,61778,731,711,6057,6734,7758,8265,246823,266742,9091,8954,68063,77655
"385","OREGON","DESCHUTES",2016,"OR",98557,41017,42444,10421,45692,"R",0.518426068802759,"ages 15-34",42351,21457,20894,19963,19299,170,117,323,301,256,389,699,759,19090,18521,2367,2373,1494,1595
"386","OREGON","DESCHUTES",2016,"OR",98557,41017,42444,10421,45692,"R",0.518426068802759,"ages 35-64",73206,35494,37712,33885,35993,190,92,391,358,378,546,580,670,33317,35452,2177,2260,1609,1719
"387","OREGON","DESCHUTES",2016,"OR",98557,41017,42444,10421,45692,"R",0.518426068802759,"ages 65+",34313,16445,17868,16043,17441,48,28,98,86,90,135,155,167,16136,17512,309,356,402,427
"388","OREGON","DESCHUTES",2016,"OR",98557,41017,42444,10421,45692,"R",0.518426068802759,"total",180819,89284,91535,84444,86551,547,355,1030,938,862,1254,2255,2318,82256,84413,7028,7122,4840,4984
"389","OREGON","DESCHUTES",2020,"OR",125234,41017,65962,3626,55646,"D",0.457585027300835,"ages 15-34",47300,24276,23024,22316,21081,226,174,379,338,303,438,1004,956,21309,20182,2967,2842,1960,1943
"390","OREGON","DESCHUTES",2020,"OR",125234,41017,65962,3626,55646,"D",0.457585027300835,"ages 35-64",80109,39215,40894,37243,38777,259,157,453,384,462,694,706,832,36470,38152,2745,2742,1972,2117
"391","OREGON","DESCHUTES",2020,"OR",125234,41017,65962,3626,55646,"D",0.457585027300835,"ages 65+",41955,19818,22137,19274,21533,63,37,143,131,132,200,190,218,19412,21591,406,546,544,604
"392","OREGON","DESCHUTES",2020,"OR",125234,41017,65962,3626,55646,"D",0.457585027300835,"total",201769,99983,101786,93850,95613,705,491,1239,1080,1096,1554,2907,2911,91567,93339,8416,8447,6133,6173
"393","OREGON","MARION",2016,"OR",136840,41047,57788,15675,63377,"R",0.52306359097099,"ages 15-34",92048,47389,44659,40800,38796,1072,591,1500,1288,1254,1317,2089,1933,31496,30234,15893,14425,6589,5863
"394","OREGON","MARION",2016,"OR",136840,41047,57788,15675,63377,"R",0.52306359097099,"ages 35-64",123314,61629,61685,55961,55787,1142,645,1447,1465,1315,1820,1269,1467,48042,49726,13587,11959,5668,5898
"395","OREGON","MARION",2016,"OR",136840,41047,57788,15675,63377,"R",0.52306359097099,"ages 65+",50091,22204,27887,21181,26601,142,114,252,251,365,582,208,283,20785,26389,1419,1498,1023,1286
"396","OREGON","MARION",2016,"OR",136840,41047,57788,15675,63377,"R",0.52306359097099,"total",335592,167232,168360,148651,150226,2942,1984,4493,4254,3668,4419,5780,5740,121551,126160,45681,42200,18581,18134
"397","OREGON","MARION",2020,"OR",165534,41047,80872,5660,79002,"D",0.494151644419981,"ages 15-34",95268,49312,45956,41989,39748,1141,711,1530,1356,1384,1318,2441,2177,31770,29863,17542,16093,7323,6208
"398","OREGON","MARION",2020,"OR",165534,41047,80872,5660,79002,"D",0.494151644419981,"ages 35-64",126791,63582,63209,57168,56604,1294,754,1634,1515,1472,1978,1394,1694,48073,49346,15509,13863,6414,6605
"399","OREGON","MARION",2020,"OR",165534,41047,80872,5660,79002,"D",0.494151644419981,"ages 65+",57493,25645,31848,24399,30130,189,159,296,347,416,744,265,381,23581,29755,2064,2093,1246,1718
"400","OREGON","MARION",2020,"OR",165534,41047,80872,5660,79002,"D",0.494151644419981,"total",349204,174220,174984,153361,154769,3292,2300,4856,4642,4109,4841,6565,6578,124319,128458,49901,46526,20859,20215
"401","PENNSYLVANIA","ERIE",2016,"PA",123679,42049,58112,5498,60069,"R",0.508279672705426,"ages 15-34",75486,38602,36884,32416,31426,4112,3396,114,89,900,848,1040,1099,36483,34934,2119,1950,6186,5458
"402","PENNSYLVANIA","ERIE",2016,"PA",123679,42049,58112,5498,60069,"R",0.508279672705426,"ages 35-64",105749,52455,53294,47761,48794,3383,3045,150,144,670,790,465,503,50977,51771,1478,1523,4694,4500
"403","PENNSYLVANIA","ERIE",2016,"PA",123679,42049,58112,5498,60069,"R",0.508279672705426,"ages 65+",46201,20356,25845,19410,24611,718,894,28,35,127,183,70,117,20098,25579,258,266,946,1234
"404","PENNSYLVANIA","ERIE",2016,"PA",123679,42049,58112,5498,60069,"R",0.508279672705426,"total",276639,136647,139992,119453,123726,11277,10192,369,324,2315,2399,3168,3278,130775,134356,5872,5636,17194,16266
"405","PENNSYLVANIA","ERIE",2020,"PA",137083,42049,68286,1928,66869,"D",0.494757870593023,"ages 15-34",70758,36328,34430,29981,28859,4067,3240,138,99,932,938,1187,1261,34022,32366,2306,2064,6347,5571
"406","PENNSYLVANIA","ERIE",2020,"PA",137083,42049,68286,1928,66869,"D",0.494757870593023,"ages 35-64",99949,49573,50376,44639,45749,3310,2941,155,168,932,930,513,566,47947,48625,1626,1751,4934,4627
"407","PENNSYLVANIA","ERIE",2020,"PA",137083,42049,68286,1928,66869,"D",0.494757870593023,"ages 65+",51518,23097,28421,21967,26945,834,1050,36,47,153,225,102,147,22784,28072,313,349,1130,1476
"408","PENNSYLVANIA","ERIE",2020,"PA",137083,42049,68286,1928,66869,"D",0.494757870593023,"total",268426,132620,135806,114816,118987,11134,9970,411,373,2760,2774,3427,3589,126314,129680,6306,6126,17804,16819
"409","PENNSYLVANIA","NORTHAMPTON",2016,"PA",143519,42095,66272,5511,71736,"R",0.519795953857747,"ages 15-34",77052,40024,37028,33601,31220,3545,3011,177,172,1552,1455,1101,1137,33287,30988,6737,6040,6423,5808
"410","PENNSYLVANIA","NORTHAMPTON",2016,"PA",143519,42095,66272,5511,71736,"R",0.519795953857747,"ages 35-64",120226,58997,61229,53097,54818,3403,3634,203,203,1609,1814,630,714,52846,54677,6151,6552,5900,6411
"411","PENNSYLVANIA","NORTHAMPTON",2016,"PA",143519,42095,66272,5511,71736,"R",0.519795953857747,"ages 65+",54908,23934,30974,22833,29536,558,759,34,84,401,439,99,145,22868,29621,1066,1353,1101,1438
"412","PENNSYLVANIA","NORTHAMPTON",2016,"PA",143519,42095,66272,5511,71736,"R",0.519795953857747,"total",301629,148452,153177,129983,134931,9908,9595,641,626,4445,4503,3294,3363,129102,134113,19350,19064,18469,18246
"413","PENNSYLVANIA","NORTHAMPTON",2020,"PA",170942,42095,85087,2001,83854,"D",0.496350797023813,"ages 15-34",78378,40644,37734,33427,31277,4056,3472,194,168,1655,1498,1264,1272,33191,30794,7453,6940,7217,6457
"414","PENNSYLVANIA","NORTHAMPTON",2020,"PA",170942,42095,85087,2001,83854,"D",0.496350797023813,"ages 35-64",117888,58143,59745,51233,52385,4166,4258,216,225,1760,1969,703,848,50542,51952,7601,7793,6910,7360
"415","PENNSYLVANIA","NORTHAMPTON",2020,"PA",170942,42095,85087,2001,83854,"D",0.496350797023813,"ages 65+",61061,26914,34147,25515,32243,732,1047,54,99,492,555,111,191,25525,32282,1389,1865,1399,1904
"416","PENNSYLVANIA","NORTHAMPTON",2020,"PA",170942,42095,85087,2001,83854,"D",0.496350797023813,"total",305892,150604,155288,129666,134469,11621,11349,686,678,4791,4808,3644,3786,128227,132936,22377,22352,20938,20819
"417","RHODE ISLAND","KENT",2016,"RI",82053,44003,37788,5929,38336,"R",0.503599390468183,"ages 15-34",39008,19843,19165,17974,17397,592,434,95,99,627,716,518,502,18402,17913,1441,1252,1869,1768
"418","RHODE ISLAND","KENT",2016,"RI",82053,44003,37788,5929,38336,"R",0.503599390468183,"ages 35-64",70006,33735,36271,31706,34267,702,603,126,118,824,903,360,357,32619,35062,1116,1209,2029,2004
"419","RHODE ISLAND","KENT",2016,"RI",82053,44003,37788,5929,38336,"R",0.503599390468183,"ages 65+",29338,12499,16839,12096,16365,142,161,33,48,171,193,52,71,12350,16624,149,215,403,474
"420","RHODE ISLAND","KENT",2016,"RI",82053,44003,37788,5929,38336,"R",0.503599390468183,"total",163842,79166,84676,73315,78980,1761,1515,340,338,2086,2235,1597,1565,75316,80913,3850,3763,5851,5696
"421","RHODE ISLAND","KENT",2020,"RI",93093,44003,49113,1979,42001,"D",0.460971969181465,"ages 15-34",39125,20009,19116,17794,17059,719,599,118,107,643,697,682,634,18186,17512,1823,1604,2215,2057
"422","RHODE ISLAND","KENT",2020,"RI",93093,44003,49113,1979,42001,"D",0.460971969181465,"ages 35-64",67919,32866,35053,30307,32579,965,767,147,150,1002,1093,417,427,31264,33404,1602,1649,2559,2474
"423","RHODE ISLAND","KENT",2020,"RI",93093,44003,49113,1979,42001,"D",0.460971969181465,"ages 65+",32853,14154,18699,13605,18041,195,244,48,59,219,258,79,95,13935,18354,219,345,549,658
"424","RHODE ISLAND","KENT",2020,"RI",93093,44003,49113,1979,42001,"D",0.460971969181465,"total",164646,79695,84951,72507,78021,2314,2044,411,419,2401,2549,1956,1853,74690,79981,5005,4970,7188,6930
"425","SOUTH CAROLINA","CLARENDON",2016,"SC",15395,45027,7732,277,7386,"D",0.488556687392512,"ages 15-34",8362,4645,3717,1876,1592,2680,2050,16,10,26,26,47,39,4477,3570,168,147,2769,2125
"426","SOUTH CAROLINA","CLARENDON",2016,"SC",15395,45027,7732,277,7386,"D",0.488556687392512,"ages 35-64",12869,6017,6852,3241,3400,2669,3330,19,27,54,57,33,34,5826,6695,191,157,2776,3452
"427","SOUTH CAROLINA","CLARENDON",2016,"SC",15395,45027,7732,277,7386,"D",0.488556687392512,"ages 65+",7499,3401,4098,2195,2350,1160,1696,12,10,11,18,22,23,3370,4058,31,40,1206,1748
"428","SOUTH CAROLINA","CLARENDON",2016,"SC",15395,45027,7732,277,7386,"D",0.488556687392512,"total",34283,16836,17447,8529,8533,7959,8543,63,63,116,123,165,176,16282,16941,554,506,8307,8914
"429","SOUTH CAROLINA","CLARENDON",2020,"SC",16733,45027,8250,122,8361,"R",0.503341159472639,"ages 15-34",7726,4211,3515,1758,1556,2375,1868,13,11,27,34,38,46,4038,3376,173,139,2453,1959
"430","SOUTH CAROLINA","CLARENDON",2020,"SC",16733,45027,8250,122,8361,"R",0.503341159472639,"ages 35-64",12319,5771,6548,3174,3293,2474,3130,21,32,55,58,46,30,5593,6373,178,175,2597,3255
"431","SOUTH CAROLINA","CLARENDON",2020,"SC",16733,45027,8250,122,8361,"R",0.503341159472639,"ages 65+",8405,3758,4647,2346,2641,1353,1933,11,16,20,23,27,33,3719,4595,39,52,1412,2006
"432","SOUTH CAROLINA","CLARENDON",2020,"SC",16733,45027,8250,122,8361,"R",0.503341159472639,"total",33415,16252,17163,8426,8572,7453,8185,58,81,131,137,180,177,15706,16626,546,537,7826,8591
"433","SOUTH CAROLINA","DILLON",2016,"SC",11698,45033,5834,227,5637,"D",0.49141312875948,"ages 15-34",7629,3707,3922,1534,1601,1960,2088,119,110,11,36,83,85,3597,3809,110,113,2173,2321
"434","SOUTH CAROLINA","DILLON",2016,"SC",11698,45033,5834,227,5637,"D",0.49141312875948,"ages 35-64",11722,5516,6206,2838,3023,2429,2915,173,194,26,26,45,47,5391,6114,125,92,2678,3183
"435","SOUTH CAROLINA","DILLON",2016,"SC",11698,45033,5834,227,5637,"D",0.49141312875948,"ages 65+",4868,2002,2866,1300,1673,632,1109,47,56,3,4,20,24,1986,2851,16,15,702,1193
"436","SOUTH CAROLINA","DILLON",2016,"SC",11698,45033,5834,227,5637,"D",0.49141312875948,"total",30695,14503,16192,6972,7606,6720,7735,448,453,57,77,300,318,14089,15768,414,424,7531,8586
"437","SOUTH CAROLINA","DILLON",2020,"SC",13101,45033,6436,83,6582,"R",0.50560762021816,"ages 15-34",7629,3693,3936,1540,1637,1926,2028,118,122,18,48,90,99,3575,3808,118,128,2153,2299
"438","SOUTH CAROLINA","DILLON",2020,"SC",13101,45033,6436,83,6582,"R",0.50560762021816,"ages 35-64",11098,5135,5963,2626,2881,2274,2812,160,193,20,24,51,52,5017,5841,118,122,2509,3082
"439","SOUTH CAROLINA","DILLON",2020,"SC",13101,45033,6436,83,6582,"R",0.50560762021816,"ages 65+",5341,2259,3082,1384,1728,785,1246,60,72,4,6,26,30,2239,3058,20,24,875,1354
"440","SOUTH CAROLINA","DILLON",2020,"SC",13101,45033,6436,83,6582,"R",0.50560762021816,"total",30367,14259,16108,6783,7509,6632,7649,447,488,74,99,317,358,13848,15636,411,472,7476,8599
"441","SOUTH DAKOTA","ZIEBACH",2016,"SD",767,46137,353,46,368,"R",0.510402219140083,"ages 15-34",813,439,374,71,76,2,0,346,281,0,2,20,15,411,362,28,12,368,298
"442","SOUTH DAKOTA","ZIEBACH",2016,"SD",767,46137,353,46,368,"R",0.510402219140083,"ages 35-64",1044,529,515,164,144,5,1,353,360,0,2,6,8,524,510,5,5,365,371
"443","SOUTH DAKOTA","ZIEBACH",2016,"SD",767,46137,353,46,368,"R",0.510402219140083,"ages 65+",264,126,138,65,54,0,0,58,81,0,0,3,3,124,138,2,0,61,84
"444","SOUTH DAKOTA","ZIEBACH",2016,"SD",767,46137,353,46,368,"R",0.510402219140083,"total",2870,1419,1451,349,336,9,3,1015,1043,1,5,44,64,1357,1395,62,56,1070,1115
"445","SOUTH DAKOTA","ZIEBACH",2020,"SD",906,46137,481,21,404,"D",0.456497175141243,"ages 15-34",812,393,419,62,83,2,0,309,316,0,2,20,18,363,408,30,11,331,336
"446","SOUTH DAKOTA","ZIEBACH",2020,"SD",906,46137,481,21,404,"D",0.456497175141243,"ages 35-64",1009,515,494,167,132,4,1,336,349,0,2,7,10,507,485,8,9,348,362
"447","SOUTH DAKOTA","ZIEBACH",2020,"SD",906,46137,481,21,404,"D",0.456497175141243,"ages 65+",301,150,151,71,53,1,0,75,95,0,0,3,3,148,151,2,0,79,98
"448","SOUTH DAKOTA","ZIEBACH",2020,"SD",906,46137,481,21,404,"D",0.456497175141243,"total",2656,1335,1321,349,318,10,4,927,936,1,5,47,58,1269,1282,66,39,986,1003
"449","TEXAS","FRIO",2016,"TX",4400,48163,2444,100,1856,"D",0.431627906976744,"ages 15-34",7190,5042,2148,4143,2052,490,32,66,18,297,20,45,24,1141,291,3901,1857,899,96
"450","TEXAS","FRIO",2016,"TX",4400,48163,2444,100,1856,"D",0.431627906976744,"ages 35-64",6174,3517,2657,3171,2542,145,40,41,33,126,23,34,18,867,574,2650,2083,346,115
"451","TEXAS","FRIO",2016,"TX",4400,48163,2444,100,1856,"D",0.431627906976744,"ages 65+",2282,1045,1237,1019,1210,8,11,2,4,5,4,11,7,329,345,716,892,26,27
"452","TEXAS","FRIO",2016,"TX",4400,48163,2444,100,1856,"D",0.431627906976744,"total",19547,11601,7946,10223,7625,684,119,128,77,454,57,111,63,2602,1485,8999,6461,1378,321
"453","TEXAS","FRIO",2020,"TX",5279,48163,2422,34,2823,"R",0.538226882745472,"ages 15-34",7487,5256,2231,4341,2115,495,53,54,25,320,15,46,22,1130,281,4126,1950,915,116
"454","TEXAS","FRIO",2020,"TX",5279,48163,2422,34,2823,"R",0.538226882745472,"ages 35-64",6509,3790,2719,3365,2600,177,41,53,28,155,26,40,23,861,528,2929,2191,425,119
"455","TEXAS","FRIO",2020,"TX",5279,48163,2422,34,2823,"R",0.538226882745472,"ages 65+",2523,1116,1407,1087,1370,9,13,4,7,9,7,7,9,332,379,784,1028,29,37
"456","TEXAS","FRIO",2020,"TX",5279,48163,2422,34,2823,"R",0.538226882745472,"total",20379,12136,8243,10649,7862,726,155,142,76,504,65,115,80,2557,1466,9579,6777,1487,381
"457","TEXAS","HAYS",2016,"TX",72164,48209,33224,5114,33826,"R",0.504489187173751,"ages 15-34",72701,36758,35943,32455,32020,2091,1899,521,419,792,661,817,899,21507,21477,15251,14466,4303,3923
"458","TEXAS","HAYS",2016,"TX",72164,48209,33224,5114,33826,"R",0.504489187173751,"ages 35-64",71085,35174,35911,32208,33085,1500,1202,428,445,483,660,470,472,23071,23453,12103,12458,2966,2826
"459","TEXAS","HAYS",2016,"TX",72164,48209,33224,5114,33826,"R",0.504489187173751,"ages 65+",21146,9719,11427,9278,10798,183,260,95,138,73,137,81,85,7859,9000,1860,2427,441,629
"460","TEXAS","HAYS",2016,"TX",72164,48209,33224,5114,33826,"R",0.504489187173751,"total",204581,101796,102785,91828,93351,4612,4121,1300,1229,1630,1708,2229,2243,62515,63749,39281,39036,9968,9434
"461","TEXAS","HAYS",2020,"TX",109395,48209,59524,2191,47680,"D",0.444759523898362,"ages 15-34",81280,40861,40419,35748,35555,2558,2347,588,498,863,807,1030,1168,22663,22844,18198,17575,5113,4864
"462","TEXAS","HAYS",2020,"TX",109395,48209,59524,2191,47680,"D",0.444759523898362,"ages 35-64",86146,42658,43488,38624,39581,2044,1645,540,562,758,962,605,687,26642,27049,16016,16439,4034,3907
"463","TEXAS","HAYS",2020,"TX",109395,48209,59524,2191,47680,"D",0.444759523898362,"ages 65+",28354,12943,15411,12253,14497,279,366,140,177,119,233,140,128,10409,11982,2534,3429,690,914
"464","TEXAS","HAYS",2020,"TX",109395,48209,59524,2191,47680,"D",0.444759523898362,"total",241365,119802,121563,107084,109234,5963,5396,1530,1547,2163,2329,2844,2916,71199,72860,48603,48703,12718,12329
"465","TEXAS","JIM WELLS",2016,"TX",12379,48249,6694,265,5420,"D",0.447416212646525,"ages 15-34",11296,5731,5565,5496,5347,96,42,72,52,30,80,34,42,887,913,4844,4652,235,218
"466","TEXAS","JIM WELLS",2016,"TX",12379,48249,6694,265,5420,"D",0.447416212646525,"ages 35-64",14164,6858,7306,6626,7113,68,39,88,66,28,50,39,37,1568,1620,5290,5686,232,193
"467","TEXAS","JIM WELLS",2016,"TX",12379,48249,6694,265,5420,"D",0.447416212646525,"ages 65+",6043,2752,3291,2671,3215,19,12,34,28,11,11,17,21,777,866,1975,2425,81,76
"468","TEXAS","JIM WELLS",2016,"TX",12379,48249,6694,265,5420,"D",0.447416212646525,"total",41206,20331,20875,19559,20210,252,144,251,199,94,160,158,150,3979,4090,16352,16785,772,665
"469","TEXAS","JIM WELLS",2020,"TX",13669,48249,6119,97,7453,"R",0.549145299145299,"ages 15-34",10640,5554,5086,5310,4890,108,41,62,47,25,62,46,43,878,830,4676,4256,244,196
"470","TEXAS","JIM WELLS",2020,"TX",13669,48249,6119,97,7453,"R",0.549145299145299,"ages 35-64",14070,6831,7239,6596,7017,71,48,87,65,27,68,40,40,1489,1590,5342,5649,235,222
"471","TEXAS","JIM WELLS",2020,"TX",13669,48249,6119,97,7453,"R",0.549145299145299,"ages 65+",6539,2964,3575,2852,3471,29,16,43,41,16,19,24,24,874,914,2090,2661,112,104
"472","TEXAS","JIM WELLS",2020,"TX",13669,48249,6119,97,7453,"R",0.549145299145299,"total",40452,20057,20395,19258,19692,285,161,240,195,91,168,168,167,3985,4012,16072,16383,799,703
"473","TEXAS","KENEDY",2016,"TX",186,48261,99,3,84,"D",0.459016393442623,"ages 15-34",107,55,52,49,48,5,1,1,2,0,0,0,1,13,14,42,38,6,4
"474","TEXAS","KENEDY",2016,"TX",186,48261,99,3,84,"D",0.459016393442623,"ages 35-64",146,73,73,70,70,2,2,0,1,1,0,0,0,19,18,54,55,3,3
"475","TEXAS","KENEDY",2016,"TX",186,48261,99,3,84,"D",0.459016393442623,"ages 65+",80,37,43,37,42,0,0,0,1,0,0,0,0,10,8,27,35,0,1
"476","TEXAS","KENEDY",2016,"TX",186,48261,99,3,84,"D",0.459016393442623,"total",427,216,211,199,200,12,5,2,4,3,0,0,2,56,51,160,160,17,11
"477","TEXAS","KENEDY",2020,"TX",194,48261,65,2,127,"R",0.661458333333333,"ages 15-34",91,49,42,38,38,6,1,1,2,2,1,2,0,14,11,35,31,11,4
"478","TEXAS","KENEDY",2020,"TX",194,48261,65,2,127,"R",0.661458333333333,"ages 35-64",152,79,73,75,67,1,2,0,1,1,0,2,3,26,16,53,57,4,6
"479","TEXAS","KENEDY",2020,"TX",194,48261,65,2,127,"R",0.661458333333333,"ages 65+",86,44,42,43,41,1,0,0,1,0,0,0,0,13,10,31,32,1,1
"480","TEXAS","KENEDY",2020,"TX",194,48261,65,2,127,"R",0.661458333333333,"total",379,198,181,174,164,12,5,3,4,5,2,4,6,60,48,138,133,24,17
"481","TEXAS","KLEBERG",2016,"TX",9512,48273,4716,429,4367,"D",0.480788285808654,"ages 15-34",12143,6533,5610,5631,5063,419,265,66,45,330,121,81,103,1988,1350,4545,4260,902,547
"482","TEXAS","KLEBERG",2016,"TX",9512,48273,4716,429,4367,"D",0.480788285808654,"ages 35-64",8833,4408,4425,4085,4080,145,143,51,59,75,91,48,44,1273,1224,3135,3201,323,345
"483","TEXAS","KLEBERG",2016,"TX",9512,48273,4716,429,4367,"D",0.480788285808654,"ages 65+",3993,1791,2202,1677,2093,56,44,15,12,25,36,15,15,712,765,1079,1437,114,109
"484","TEXAS","KLEBERG",2016,"TX",9512,48273,4716,429,4367,"D",0.480788285808654,"total",31309,15978,15331,14309,14027,771,578,163,137,485,289,231,270,4659,3953,11319,11378,1669,1304
"485","TEXAS","KLEBERG",2020,"TX",10944,48273,5314,126,5504,"R",0.50878166019597,"ages 15-34",11382,5964,5418,5142,4927,357,201,65,39,314,139,77,103,1797,1222,4167,4196,822,491
"486","TEXAS","KLEBERG",2020,"TX",10944,48273,5314,126,5504,"R",0.50878166019597,"ages 35-64",8699,4391,4308,4049,3988,151,127,64,56,71,82,50,47,1219,1117,3172,3191,342,320
"487","TEXAS","KLEBERG",2020,"TX",10944,48273,5314,126,5504,"R",0.50878166019597,"ages 65+",4163,1867,2296,1730,2166,64,50,26,23,27,41,19,14,701,768,1166,1528,137,130
"488","TEXAS","KLEBERG",2020,"TX",10944,48273,5314,126,5504,"R",0.50878166019597,"total",30338,15398,14940,13808,13700,699,496,189,146,457,296,222,273,4368,3695,11030,11245,1590,1240
"489","TEXAS","LA SALLE",2016,"TX",2059,48283,1129,58,872,"D",0.435782108945527,"ages 15-34",2964,2098,866,2049,832,13,19,21,6,3,4,12,5,140,97,1958,769,49,34
"490","TEXAS","LA SALLE",2016,"TX",2059,48283,1129,58,872,"D",0.435782108945527,"ages 35-64",2327,1259,1068,1213,1033,23,13,12,5,6,9,5,7,206,172,1053,896,46,35
"491","TEXAS","LA SALLE",2016,"TX",2059,48283,1129,58,872,"D",0.435782108945527,"ages 65+",1015,466,549,450,533,8,4,3,5,2,3,3,3,150,155,316,394,16,16
"492","TEXAS","LA SALLE",2016,"TX",2059,48283,1129,58,872,"D",0.435782108945527,"total",7600,4509,3091,4371,2984,57,49,37,17,15,18,29,21,580,491,3929,2600,138,107
"493","TEXAS","LA SALLE",2020,"TX",2406,48283,1052,19,1335,"R",0.559279430247172,"ages 15-34",2828,2017,811,1958,776,20,19,21,4,3,6,15,6,133,94,1884,717,59,35
"494","TEXAS","LA SALLE",2020,"TX",2406,48283,1052,19,1335,"R",0.559279430247172,"ages 35-64",2413,1312,1101,1259,1057,19,21,19,9,3,6,12,8,171,138,1141,963,53,44
"495","TEXAS","LA SALLE",2020,"TX",2406,48283,1052,19,1335,"R",0.559279430247172,"ages 65+",1054,476,578,450,553,11,11,9,6,3,3,3,3,137,150,339,428,26,25
"496","TEXAS","LA SALLE",2020,"TX",2406,48283,1052,19,1335,"R",0.559279430247172,"total",7500,4437,3063,4266,2931,65,63,52,24,15,18,39,25,526,461,3911,2602,171,132
"497","TEXAS","REEVES",2016,"TX",3184,48389,1659,108,1417,"D",0.460663198959688,"ages 15-34",5070,3499,1571,3045,1435,346,50,20,20,66,41,20,21,1100,266,2399,1305,454,136
"498","TEXAS","REEVES",2016,"TX",3184,48389,1659,108,1417,"D",0.460663198959688,"ages 35-64",5511,3575,1936,3224,1828,280,42,25,30,33,22,12,12,1171,397,2404,1539,351,108
"499","TEXAS","REEVES",2016,"TX",3184,48389,1659,108,1417,"D",0.460663198959688,"ages 65+",1789,810,979,770,917,15,28,7,11,15,14,2,8,208,271,602,708,40,62
"500","TEXAS","REEVES",2016,"TX",3184,48389,1659,108,1417,"D",0.460663198959688,"total",15203,9324,5879,8365,5498,682,150,66,69,141,95,66,60,2687,1153,6637,4726,959,381
"501","TEXAS","REEVES",2020,"TX",3689,48389,1395,40,2254,"R",0.61770348040559,"ages 15-34",5295,3649,1646,3173,1494,356,55,30,19,68,45,19,29,1152,332,2497,1314,476,152
"502","TEXAS","REEVES",2020,"TX",3689,48389,1395,40,2254,"R",0.61770348040559,"ages 35-64",5815,3730,2085,3357,1961,276,49,28,34,45,24,23,15,1167,428,2563,1657,373,124
"503","TEXAS","REEVES",2020,"TX",3689,48389,1395,40,2254,"R",0.61770348040559,"ages 65+",1853,851,1002,794,935,21,26,11,15,19,17,5,8,220,251,631,751,57,67
"504","TEXAS","REEVES",2020,"TX",3689,48389,1395,40,2254,"R",0.61770348040559,"total",15949,9743,6206,8680,5751,713,178,104,81,152,101,89,88,2785,1236,6958,4970,1063,455
"505","TEXAS","TARRANT",2016,"TX",668514,48439,288392,34201,345921,"R",0.54534748617796,"ages 15-34",582106,289065,293041,210353,207948,50802,56170,2946,2837,16632,17568,7531,7666,192388,199357,96677,93684,78712,85093
"506","TEXAS","TARRANT",2016,"TX",668514,48439,288392,34201,345921,"R",0.54534748617796,"ages 35-64",773641,376654,396987,287761,293340,58134,69109,3463,3438,21320,24300,5140,5913,283841,305480,92813,91507,88893,103647
"507","TEXAS","TARRANT",2016,"TX",668514,48439,288392,34201,345921,"R",0.54534748617796,"ages 65+",216748,94546,122202,79228,100980,9226,13956,644,722,4542,5434,795,981,83029,108143,11517,14059,15318,21222
"508","TEXAS","TARRANT",2016,"TX",668514,48439,288392,34201,345921,"R",0.54534748617796,"total",2023942,990557,1033385,739707,758103,161147,180744,9048,8837,54435,58656,23911,24658,701688,749286,288869,284099,250850,275282
"509","TEXAS","TARRANT",2020,"TX",834697,48439,411567,13389,409741,"D",0.498888358569501,"ages 15-34",612104,304335,307769,215284,211998,58359,63128,3074,3124,17693,19200,9092,9443,197885,203565,106450,104204,89051,95771
"510","TEXAS","TARRANT",2020,"TX",834697,48439,411567,13389,409741,"D",0.498888358569501,"ages 35-64",804587,391350,413237,291065,295210,65566,78694,3669,3589,24220,27984,5814,6708,285614,308949,105736,104288,100285,118027
"511","TEXAS","TARRANT",2020,"TX",834697,48439,411567,13389,409741,"D",0.498888358569501,"ages 65+",254161,111366,142795,91332,114819,11993,18255,807,877,6022,7324,1049,1280,96146,124161,15220,18634,20034,27976
"512","TEXAS","TARRANT",2020,"TX",834697,48439,411567,13389,409741,"D",0.498888358569501,"total",2123347,1037319,1086028,754421,773331,182675,205663,9616,9470,60560,66494,27437,28318,720804,772910,316515,313118,282898,312697
"513","TEXAS","VAL VERDE",2016,"TX",13617,48465,6964,763,5890,"D",0.458223121207406,"ages 15-34",14724,8131,6593,7603,6227,238,139,84,60,68,82,120,73,1833,1113,6298,5480,528,366
"514","TEXAS","VAL VERDE",2016,"TX",13617,48465,6964,763,5890,"D",0.458223121207406,"ages 35-64",15497,7656,7841,7321,7523,139,106,74,76,53,76,54,51,1502,1306,6154,6535,335,318
"515","TEXAS","VAL VERDE",2016,"TX",13617,48465,6964,763,5890,"D",0.458223121207406,"ages 65+",6878,3170,3708,3052,3603,55,38,29,19,10,25,21,18,913,850,2257,2858,118,105
"516","TEXAS","VAL VERDE",2016,"TX",13617,48465,6964,763,5890,"D",0.458223121207406,"total",48901,25007,23894,23719,22840,533,395,234,196,194,218,288,213,4990,3922,20017,19972,1288,1054
"517","TEXAS","VAL VERDE",2020,"TX",15280,48465,6771,225,8284,"R",0.550249086682165,"ages 15-34",14969,8292,6677,7715,6230,233,194,97,66,102,86,129,89,1824,1088,6468,5589,577,447
"518","TEXAS","VAL VERDE",2020,"TX",15280,48465,6771,225,8284,"R",0.550249086682165,"ages 35-64",15487,7774,7713,7338,7351,199,123,88,91,55,77,74,59,1422,1184,6352,6529,436,362
"519","TEXAS","VAL VERDE",2020,"TX",15280,48465,6771,225,8284,"R",0.550249086682165,"ages 65+",6994,3151,3843,3003,3721,75,50,41,23,9,27,21,18,872,813,2279,3030,148,122
"520","TEXAS","VAL VERDE",2020,"TX",15280,48465,6771,225,8284,"R",0.550249086682165,"total",49028,25053,23975,23546,22702,647,519,281,241,215,224,316,247,4819,3797,20234,20178,1507,1273
"521","TEXAS","WILLIAMSON",2016,"TX",203081,48491,84468,14438,104175,"R",0.5522335840715,"ages 15-34",139671,69621,70050,56494,56670,5837,5395,701,721,4339,4984,2113,2181,48482,49251,21139,20799,13127,13380
"522","TEXAS","WILLIAMSON",2016,"TX",203081,48491,84468,14438,104175,"R",0.5522335840715,"ages 35-64",212280,104081,108199,86773,89694,7076,7733,924,887,7566,7991,1587,1728,82509,85288,21572,22911,17308,18505
"523","TEXAS","WILLIAMSON",2016,"TX",203081,48491,84468,14438,104175,"R",0.5522335840715,"ages 65+",60725,26921,33804,24547,30806,883,1255,159,180,1089,1324,218,211,24415,30274,2506,3530,2374,2998
"524","TEXAS","WILLIAMSON",2016,"TX",203081,48491,84468,14438,104175,"R",0.5522335840715,"total",528207,259917,268290,213920,221194,18158,18475,2370,2311,17768,18757,7270,7152,196630,203741,63287,64549,45997,47096
"525","TEXAS","WILLIAMSON",2020,"TX",289555,48491,143795,6031,139729,"D",0.492829531186072,"ages 15-34",161869,81234,80635,63635,63133,7369,6963,878,780,6237,6774,2972,2859,56372,55785,24862,24850,17599,17502
"526","TEXAS","WILLIAMSON",2020,"TX",289555,48491,143795,6031,139729,"D",0.492829531186072,"ages 35-64",249880,123857,126023,99200,100872,9279,9630,1131,1063,11900,11972,2137,2297,96002,97331,27855,28692,24657,25151
"527","TEXAS","WILLIAMSON",2020,"TX",289555,48491,143795,6031,139729,"D",0.492829531186072,"ages 65+",79469,35097,44372,31477,39651,1303,1963,238,241,1742,2135,295,341,31390,39325,3707,5047,3620,4721
"528","TEXAS","WILLIAMSON",2020,"TX",289555,48491,143795,6031,139729,"D",0.492829531186072,"total",617855,305101,312754,242621,249891,23196,23646,2877,2622,26494,26925,9371,9184,228932,235044,76169,77710,62480,62863
"529","TEXAS","ZAPATA",2016,"TX",3142,48505,2063,50,1029,"D",0.332794307891332,"ages 15-34",4055,2024,2031,1993,2006,8,6,13,8,5,6,5,4,59,50,1965,1981,31,25
"530","TEXAS","ZAPATA",2016,"TX",3142,48505,2063,50,1029,"D",0.332794307891332,"ages 35-64",4454,2142,2312,2100,2277,14,7,13,11,6,11,9,6,130,123,2012,2189,42,35
"531","TEXAS","ZAPATA",2016,"TX",3142,48505,2063,50,1029,"D",0.332794307891332,"ages 65+",1758,824,934,816,917,4,1,3,11,1,3,0,2,184,182,640,752,8,17
"532","TEXAS","ZAPATA",2016,"TX",3142,48505,2063,50,1029,"D",0.332794307891332,"total",14420,7211,7209,7107,7104,31,19,32,35,14,26,24,23,430,402,6781,6807,104,105
"533","TEXAS","ZAPATA",2020,"TX",3874,48505,1826,15,2033,"R",0.526820419797875,"ages 15-34",3936,2013,1923,1981,1886,11,9,11,11,5,9,5,8,66,53,1947,1870,32,37
"534","TEXAS","ZAPATA",2020,"TX",3874,48505,1826,15,2033,"R",0.526820419797875,"ages 35-64",4441,2101,2340,2056,2310,15,5,13,10,5,6,12,8,102,86,1999,2254,45,30
"535","TEXAS","ZAPATA",2020,"TX",3874,48505,1826,15,2033,"R",0.526820419797875,"ages 65+",1919,908,1011,890,988,8,3,5,13,1,5,4,2,159,167,749,844,18,23
"536","TEXAS","ZAPATA",2020,"TX",3874,48505,1826,15,2033,"R",0.526820419797875,"total",14172,7074,7098,6950,6982,48,31,32,37,12,22,31,25,368,343,6706,6755,124,116
"537","UTAH","GRAND",2016,"UT",4533,49019,1960,598,1975,"R",0.501905972045743,"ages 15-34",2226,1118,1108,976,983,8,9,80,58,20,34,32,22,976,955,142,153,142,125
"538","UTAH","GRAND",2016,"UT",4533,49019,1960,598,1975,"R",0.501905972045743,"ages 35-64",3948,1999,1949,1855,1803,28,4,65,83,18,27,32,31,1847,1791,152,158,144,146
"539","UTAH","GRAND",2016,"UT",4533,49019,1960,598,1975,"R",0.501905972045743,"ages 65+",1666,817,849,799,828,0,0,9,9,5,5,4,7,796,824,21,25,18,21
"540","UTAH","GRAND",2016,"UT",4533,49019,1960,598,1975,"R",0.501905972045743,"total",9616,4818,4798,4389,4378,45,21,233,212,52,88,96,95,4335,4307,483,491,429,420
"541","UTAH","GRAND",2020,"UT",5185,49019,2806,131,2248,"D",0.444796201028888,"ages 15-34",2342,1166,1176,1008,998,17,7,77,79,23,63,40,26,1016,1016,150,160,158,178
"542","UTAH","GRAND",2020,"UT",5185,49019,2806,131,2248,"D",0.444796201028888,"ages 35-64",3800,1908,1892,1746,1741,37,11,79,78,21,28,23,34,1752,1728,156,164,162,151
"543","UTAH","GRAND",2020,"UT",5185,49019,2806,131,2248,"D",0.444796201028888,"ages 65+",1932,955,977,924,947,3,1,13,11,7,10,8,8,917,946,38,31,31,30
"544","UTAH","GRAND",2020,"UT",5185,49019,2806,131,2248,"D",0.444796201028888,"total",9796,4879,4917,4380,4391,65,30,259,223,66,150,104,117,4358,4401,521,516,499,526
"545","VIRGINIA","CHESTERFIELD",2016,"VA",176461,51041,81074,10342,85045,"R",0.511952275176229,"ages 15-34",85586,42258,43328,27290,26819,11730,13019,332,301,1473,1557,1367,1575,37506,38919,4752,4409,14968,16509
"546","VIRGINIA","CHESTERFIELD",2016,"VA",176461,51041,81074,10342,85045,"R",0.511952275176229,"ages 35-64",139561,65996,73565,47951,50556,14249,18341,422,365,2484,3114,807,1094,60948,68798,5048,4767,18045,23009
"547","VIRGINIA","CHESTERFIELD",2016,"VA",176461,51041,81074,10342,85045,"R",0.511952275176229,"ages 65+",47305,21019,26286,17208,21192,2841,4071,94,81,740,770,121,161,20545,25755,474,531,3811,5094
"548","VIRGINIA","CHESTERFIELD",2016,"VA",176461,51041,81074,10342,85045,"R",0.511952275176229,"total",338677,163268,175409,114919,119941,36823,43152,1030,897,5942,6489,4329,4707,148669,161540,14599,13869,48349,55468
"549","VIRGINIA","CHESTERFIELD",2020,"VA",203955,51041,106935,3694,93326,"D",0.466021841496847,"ages 15-34",89655,44099,45556,27433,27569,12893,14054,396,368,1567,1621,1738,1895,38461,40090,5638,5466,16666,17987
"550","VIRGINIA","CHESTERFIELD",2020,"VA",203955,51041,106935,3694,93326,"D",0.466021841496847,"ages 35-64",142568,67604,74964,47757,50257,15587,19669,473,356,2665,3249,1011,1325,61265,69069,6339,5895,19847,24707
"551","VIRGINIA","CHESTERFIELD",2020,"VA",203955,51041,106935,3694,93326,"D",0.466021841496847,"ages 65+",56749,25098,31651,19948,24519,3980,5758,94,94,918,1037,144,227,24398,30883,700,768,5150,7132
"552","VIRGINIA","CHESTERFIELD",2020,"VA",203955,51041,106935,3694,93326,"D",0.466021841496847,"total",358245,172281,185964,117995,124239,41254,47935,1194,1023,6403,6964,5162,5561,154323,168843,17958,17121,54286,61725
"553","VIRGINIA","JAMES CITY",2016,"VA",43173,51095,19105,2762,21306,"R",0.527232684170152,"ages 15-34",15721,7946,7775,5947,5851,1360,1314,52,36,249,242,329,316,7237,7145,709,630,1999,1924
"554","VIRGINIA","JAMES CITY",2016,"VA",43173,51095,19105,2762,21306,"R",0.527232684170152,"ages 35-64",28367,13455,14912,10932,12015,1925,2113,63,58,327,491,200,218,12778,14191,677,721,2523,2897
"555","VIRGINIA","JAMES CITY",2016,"VA",43173,51095,19105,2762,21306,"R",0.527232684170152,"ages 65+",17932,8190,9742,7448,8700,591,802,19,18,89,165,39,55,8099,9624,91,118,742,1042
"556","VIRGINIA","JAMES CITY",2016,"VA",43173,51095,19105,2762,21306,"R",0.527232684170152,"total",74075,35692,38383,28802,30899,4835,5212,162,136,852,1096,1017,1003,33641,36313,2051,2070,6890,7484
"557","VIRGINIA","JAMES CITY",2020,"VA",49639,51095,25553,933,23153,"D",0.475362378351743,"ages 15-34",15860,8068,7792,5944,5821,1426,1298,47,39,262,269,375,345,7327,7088,741,704,2124,1971
"558","VIRGINIA","JAMES CITY",2020,"VA",49639,51095,25553,933,23153,"D",0.475362378351743,"ages 35-64",28777,13704,15073,11008,11945,2017,2264,62,83,367,510,245,254,12812,14206,892,867,2696,3128
"559","VIRGINIA","JAMES CITY",2020,"VA",49639,51095,25553,933,23153,"D",0.475362378351743,"ages 65+",20755,9420,11335,8457,9999,725,990,28,22,145,245,58,75,9288,11148,132,187,963,1336
"560","VIRGINIA","JAMES CITY",2020,"VA",49639,51095,25553,933,23153,"D",0.475362378351743,"total",77612,37409,40203,29931,32072,5188,5544,163,177,927,1235,1170,1129,34993,37727,2416,2476,7478,8131
"561","VIRGINIA","RICHMOND",2016,"VA",3661,51159,1347,6745,2213,"R",0.621629213483146,"ages 15-34",2097,1321,776,698,520,575,219,12,6,10,3,26,28,1165,710,156,66,623,256
"562","VIRGINIA","RICHMOND",2016,"VA",3661,51159,1347,6745,2213,"R",0.621629213483146,"ages 35-64",3578,2155,1423,1359,1068,759,318,8,5,10,13,19,19,2031,1340,124,83,796,355
"563","VIRGINIA","RICHMOND",2016,"VA",3661,51159,1347,6745,2213,"R",0.621629213483146,"ages 65+",1861,757,1104,564,858,182,234,2,2,4,3,4,6,748,1093,9,11,193,246
"564","VIRGINIA","RICHMOND",2016,"VA",3661,51159,1347,6745,2213,"R",0.621629213483146,"total",8755,4848,3907,3034,2849,1670,929,26,15,32,21,85,92,4470,3683,378,224,1814,1058
"565","VIRGINIA","RICHMOND",2020,"VA",4102,51159,1513,42,2547,"R",0.627339901477832,"ages 15-34",2219,1455,764,747,507,646,207,10,6,16,7,35,36,1317,706,138,58,708,257
"566","VIRGINIA","RICHMOND",2020,"VA",4102,51159,1513,42,2547,"R",0.627339901477832,"ages 35-64",3610,2226,1384,1397,1039,787,301,8,9,10,12,24,23,2044,1291,182,93,829,345
"567","VIRGINIA","RICHMOND",2020,"VA",4102,51159,1513,42,2547,"R",0.627339901477832,"ages 65+",1985,814,1171,621,900,179,256,5,2,5,5,3,6,801,1158,13,13,193,271
"568","VIRGINIA","RICHMOND",2020,"VA",4102,51159,1513,42,2547,"R",0.627339901477832,"total",9071,5129,3942,3191,2862,1764,919,30,24,37,26,105,108,4698,3694,431,248,1938,1080
"569","VIRGINIA","STAFFORD",2016,"VA",65934,51179,27908,4158,33868,"R",0.548238798238798,"ages 15-34",40311,21268,19043,15439,13381,4070,3767,158,132,646,755,925,967,18147,16287,3121,2756,5829,5662
"570","VIRGINIA","STAFFORD",2016,"VA",65934,51179,27908,4158,33868,"R",0.548238798238798,"ages 35-64",58705,29159,29546,21910,21504,5599,5766,208,173,822,1351,574,701,26120,26495,3039,3051,7249,8042
"571","VIRGINIA","STAFFORD",2016,"VA",65934,51179,27908,4158,33868,"R",0.548238798238798,"ages 65+",14080,6393,7687,5414,6330,723,900,37,50,158,321,58,76,6171,7342,222,345,979,1357
"572","VIRGINIA","STAFFORD",2016,"VA",65934,51179,27908,4158,33868,"R",0.548238798238798,"total",143641,72472,71169,53562,51436,13243,13281,519,441,2130,2903,2908,2977,63510,62604,8962,8565,18910,19733
"573","VIRGINIA","STAFFORD",2020,"VA",79629,51179,40245,1748,37636,"D",0.48325008667069,"ages 15-34",43432,23265,20167,16242,13483,4837,4450,236,178,736,822,1184,1196,19408,16689,3857,3478,7023,6684
"574","VIRGINIA","STAFFORD",2020,"VA",79629,51179,40245,1748,37636,"D",0.48325008667069,"ages 35-64",63075,31421,31654,22442,22051,6884,6903,271,216,1017,1587,761,845,27145,27536,4276,4118,8979,9603
"575","VIRGINIA","STAFFORD",2020,"VA",79629,51179,40245,1748,37636,"D",0.48325008667069,"ages 65+",17216,7803,9413,6372,7445,1052,1345,51,62,226,411,94,117,7429,8891,374,522,1431,1968
"576","VIRGINIA","STAFFORD",2020,"VA",79629,51179,40245,1748,37636,"D",0.48325008667069,"total",156748,79412,77336,56047,53406,16335,16053,698,569,2563,3421,3644,3727,67682,66205,11730,11131,23365,23930
"577","WASHINGTON","CLALLAM",2016,"WA",39457,53009,17677,2986,18794,"R",0.515313536782649,"ages 15-34",15004,8097,6907,6496,5666,293,70,637,532,152,171,489,450,7194,6272,903,635,1601,1241
"578","WASHINGTON","CLALLAM",2016,"WA",39457,53009,17677,2986,18794,"R",0.515313536782649,"ages 35-64",27855,13435,14420,11951,12850,208,58,722,750,172,351,357,385,12796,13771,639,649,1484,1570
"579","WASHINGTON","CLALLAM",2016,"WA",39457,53009,17677,2986,18794,"R",0.515313536782649,"ages 65+",20839,9738,11101,9328,10543,32,15,166,212,83,183,121,135,9592,10929,146,172,410,558
"580","WASHINGTON","CLALLAM",2016,"WA",39457,53009,17677,2986,18794,"R",0.515313536782649,"total",74351,36733,37618,32010,32984,592,194,2150,2105,472,791,1433,1477,34237,35402,2496,2216,4723,4634
"581","WASHINGTON","CLALLAM",2020,"WA",49264,53009,24721,1481,23062,"D",0.482640269551933,"ages 15-34",15007,7982,7025,6358,5637,296,86,610,567,183,209,514,509,6993,6258,989,767,1624,1388
"582","WASHINGTON","CLALLAM",2020,"WA",49264,53009,24721,1481,23062,"D",0.482640269551933,"ages 35-64",27977,13553,14424,11928,12675,225,80,726,769,204,424,438,447,12762,13629,791,795,1625,1749
"583","WASHINGTON","CLALLAM",2020,"WA",49264,53009,24721,1481,23062,"D",0.482640269551933,"ages 65+",24362,11309,13053,10738,12317,58,20,231,288,113,230,156,186,11098,12804,211,249,571,736
"584","WASHINGTON","CLALLAM",2020,"WA",49264,53009,24721,1481,23062,"D",0.482640269551933,"total",78067,38405,39662,33145,34504,660,252,2253,2228,605,946,1658,1663,35507,37040,2898,2622,5260,5158
"585","WISCONSIN","DOOR",2016,"WI",17608,55029,8026,998,8584,"R",0.516797110174594,"ages 15-34",4809,2446,2363,2310,2238,49,28,25,22,13,29,46,46,2310,2245,136,118,136,125
"586","WISCONSIN","DOOR",2016,"WI",17608,55029,8026,998,8584,"R",0.516797110174594,"ages 35-64",11180,5583,5597,5422,5475,36,23,48,40,23,24,53,31,5451,5477,132,120,161,122
"587","WISCONSIN","DOOR",2016,"WI",17608,55029,8026,998,8584,"R",0.516797110174594,"ages 65+",7672,3552,4120,3513,4085,6,0,9,6,5,11,18,18,3537,4095,15,25,39,35
"588","WISCONSIN","DOOR",2016,"WI",17608,55029,8026,998,8584,"R",0.516797110174594,"total",27354,13499,13855,13023,13467,106,64,104,93,61,75,198,152,13090,13453,409,402,476,388
"589","WISCONSIN","DOOR",2020,"WI",20117,55029,10044,321,9752,"D",0.49262477268135,"ages 15-34",4858,2511,2347,2365,2180,48,42,22,31,21,32,52,62,2317,2184,194,163,146,167
"590","WISCONSIN","DOOR",2020,"WI",20117,55029,10044,321,9752,"D",0.49262477268135,"ages 35-64",10680,5327,5353,5160,5216,48,22,39,42,28,29,52,41,5156,5213,171,140,167,137
"591","WISCONSIN","DOOR",2020,"WI",20117,55029,10044,321,9752,"D",0.49262477268135,"ages 65+",8735,4122,4613,4054,4552,13,11,21,10,9,15,23,24,4094,4573,28,40,68,61
"592","WISCONSIN","DOOR",2020,"WI",20117,55029,10044,321,9752,"D",0.49262477268135,"total",27889,13836,14053,13320,13567,128,95,111,114,73,87,197,186,13288,13568,548,485,516,486
"593","WISCONSIN","SAUK",2016,"WI",31318,55111,14692,1835,14791,"R",0.501678933622766,"ages 15-34",15047,7747,7300,7254,6835,170,113,131,152,71,92,117,105,7210,6871,537,429,493,465
"594","WISCONSIN","SAUK",2016,"WI",31318,55111,14692,1835,14791,"R",0.501678933622766,"ages 35-64",25404,12819,12585,12423,12226,125,48,133,140,62,97,72,72,12315,12174,504,411,396,359
"595","WISCONSIN","SAUK",2016,"WI",31318,55111,14692,1835,14791,"R",0.501678933622766,"ages 65+",11127,4959,6168,4909,6079,13,9,20,40,7,17,10,23,4928,6126,31,42,50,89
"596","WISCONSIN","SAUK",2016,"WI",31318,55111,14692,1835,14791,"R",0.501678933622766,"total",63627,31731,31896,30356,30526,387,266,428,480,184,255,367,361,30084,30403,1647,1493,1375,1370
"597","WISCONSIN","SAUK",2020,"WI",36203,55111,18108,602,17493,"D",0.491362602174096,"ages 15-34",14677,7547,7130,6958,6602,207,176,134,138,90,83,154,124,6912,6618,635,512,589,528
"598","WISCONSIN","SAUK",2020,"WI",36203,55111,18108,602,17493,"D",0.491362602174096,"ages 35-64",25092,12666,12426,12169,12013,171,74,156,155,70,95,94,86,12050,11903,616,523,497,413
"599","WISCONSIN","SAUK",2020,"WI",36203,55111,18108,602,17493,"D",0.491362602174096,"ages 65+",12626,5777,6849,5705,6733,21,16,27,41,10,30,14,29,5726,6792,51,57,72,116
"600","WISCONSIN","SAUK",2020,"WI",36203,55111,18108,602,17493,"D",0.491362602174096,"total",64449,32143,32306,30513,30747,493,382,468,477,219,258,439,430,30210,30543,1933,1763,1630,1559
"601","WYOMING","ALBANY",2016,"WY",17060,56001,6890,2568,7602,"R",0.524565277394424,"ages 15-34",17818,9627,8191,8677,7396,203,85,100,85,418,349,221,269,8851,7452,776,739,950,795
"602","WYOMING","ALBANY",2016,"WY",17060,56001,6890,2568,7602,"R",0.524565277394424,"ages 35-64",10723,5489,5234,5086,4870,127,53,60,58,133,163,75,88,4991,4775,498,459,403,364
"603","WYOMING","ALBANY",2016,"WY",17060,56001,6890,2568,7602,"R",0.524565277394424,"ages 65+",4141,1996,2145,1910,2070,20,13,25,14,23,34,17,13,1864,1991,132,154,86,75
"604","WYOMING","ALBANY",2016,"WY",17060,56001,6890,2568,7602,"R",0.524565277394424,"total",38012,19908,18104,18169,16575,421,221,225,194,653,623,420,479,18059,16385,1849,1719,1739,1529
"605","WYOMING","ALBANY",2020,"WY",18744,56001,9092,1073,8579,"D",0.485484692433931,"ages 15-34",17670,9484,8186,8465,7387,185,83,86,80,490,334,245,297,8656,7406,828,780,1019,799
"606","WYOMING","ALBANY",2020,"WY",18744,56001,9092,1073,8579,"D",0.485484692433931,"ages 35-64",11092,5704,5388,5214,5012,114,48,85,65,194,163,88,91,5176,4865,528,523,490,376
"607","WYOMING","ALBANY",2020,"WY",18744,56001,9092,1073,8579,"D",0.485484692433931,"ages 65+",5026,2405,2621,2283,2515,38,15,24,20,33,44,24,26,2247,2417,158,204,122,106
"608","WYOMING","ALBANY",2020,"WY",18744,56001,9092,1073,8579,"D",0.485484692433931,"total",38950,20260,18690,18289,17139,398,182,256,204,786,609,503,539,18311,16813,1949,1877,1971,1551
